三明市清流县公安局	福建省三明市清流县
三明市将乐县公安局	福建省三明市将乐县
三明市梅列区公安局	福建省三明市梅列区
三明市建宁县公安局	福建省三明市建宁县
三明市永安市公安局	福建省三明市永安市
三明市三元区公安局	福建省三明市三元区
三明市明溪县公安局	福建省三明市明溪县
三明市大田县公安局	福建省三明市大田县
三明市尤溪县公安局	福建省三明市尤溪县
三明市宁化县公安局	福建省三明市宁化县
三明市泰宁县公安局	福建省三明市泰宁县
西宁市湟源县公安局	青海省西宁市湟源县
西宁市湟中县公安局	青海省西宁市湟中县
西宁市城东区公安局	青海省西宁市城东区
西宁市城西区公安局	青海省西宁市城西区
西宁市大通回族土族自治县公安局	青海省西宁市大通回族土族自治县
西宁市城北区公安局	青海省西宁市城北区
西宁市城中区公安局	青海省西宁市城中区
海北藏族自治州刚察县公安局	青海省海北藏族自治州刚察县
海北藏族自治州祁连县公安局	青海省海北藏族自治州祁连县
海北藏族自治州海晏县公安局	青海省海北藏族自治州海晏县
海北藏族自治州门源回族自治县公安局	青海省海北藏族自治州门源回族自治县
黄南藏族自治州同仁县公安局	青海省黄南藏族自治州同仁县
黄南藏族自治州河南蒙古族自治县公安局	青海省黄南藏族自治州河南蒙古族自治县
黄南藏族自治州尖扎县公安局	青海省黄南藏族自治州尖扎县
黄南藏族自治州泽库县公安局	青海省黄南藏族自治州泽库县
海西蒙古族藏族自治州德令哈市公安局	青海省海西蒙古族藏族自治州德令哈市
海西蒙古族藏族自治州格尔木市公安局	青海省海西蒙古族藏族自治州格尔木市
海西蒙古族藏族自治州乌兰县公安局	青海省海西蒙古族藏族自治州乌兰县
海西蒙古族藏族自治州茫崖市公安局	青海省海西蒙古族藏族自治州茫崖市
海西蒙古族藏族自治州都兰县公安局	青海省海西蒙古族藏族自治州都兰县
海西蒙古族藏族自治州天峻县公安局	青海省海西蒙古族藏族自治州天峻县
海西蒙古族藏族自治州大柴旦行政委员会公安局	青海省海西蒙古族藏族自治州大柴旦行政委员会
海东市乐都区公安局	青海省海东市乐都区
海东市民和回族土族自治县公安局	青海省海东市民和回族土族自治县
海东市平安区公安局	青海省海东市平安区
海东市互助土族自治县公安局	青海省海东市互助土族自治县
海东市循化撒拉族自治县公安局	青海省海东市循化撒拉族自治县
海东市化隆回族自治县公安局	青海省海东市化隆回族自治县
玉树藏族自治州曲麻莱县公安局	青海省玉树藏族自治州曲麻莱县
玉树藏族自治州囊谦县公安局	青海省玉树藏族自治州囊谦县
玉树藏族自治州玉树市公安局	青海省玉树藏族自治州玉树市
玉树藏族自治州治多县公安局	青海省玉树藏族自治州治多县
玉树藏族自治州称多县公安局	青海省玉树藏族自治州称多县
玉树藏族自治州杂多县公安局	青海省玉树藏族自治州杂多县
果洛藏族自治州玛多县公安局	青海省果洛藏族自治州玛多县
果洛藏族自治州玛沁县公安局	青海省果洛藏族自治州玛沁县
果洛藏族自治州久治县公安局	青海省果洛藏族自治州久治县
果洛藏族自治州甘德县公安局	青海省果洛藏族自治州甘德县
果洛藏族自治州班玛县公安局	青海省果洛藏族自治州班玛县
果洛藏族自治州达日县公安局	青海省果洛藏族自治州达日县
海南藏族自治州共和县公安局	青海省海南藏族自治州共和县
海南藏族自治州贵德县公安局	青海省海南藏族自治州贵德县
海南藏族自治州兴海县公安局	青海省海南藏族自治州兴海县
海南藏族自治州贵南县公安局	青海省海南藏族自治州贵南县
海南藏族自治州同德县公安局	青海省海南藏族自治州同德县
三亚市海棠区公安局	海南省三亚市海棠区
三亚市天涯区公安局	海南省三亚市天涯区
三亚市崖州区公安局	海南省三亚市崖州区
三亚市吉阳区公安局	海南省三亚市吉阳区
白城市洮南市公安局	吉林省白城市洮南市
白城市大安市公安局	吉林省白城市大安市
白城市吉林白城经济开发区公安局	吉林省白城市吉林白城经济开发区
白城市洮北区公安局	吉林省白城市洮北区
白城市通榆县公安局	吉林省白城市通榆县
白城市镇赉县公安局	吉林省白城市镇赉县
辽源市西安区公安局	吉林省辽源市西安区
辽源市龙山区公安局	吉林省辽源市龙山区
辽源市东辽县公安局	吉林省辽源市东辽县
辽源市东丰县公安局	吉林省辽源市东丰县
吉林市吉林经济开发区公安局	吉林省吉林市吉林经济开发区
吉林市吉林中国新加坡食品区公安局	吉林省吉林市吉林中国新加坡食品区
吉林市磐石市公安局	吉林省吉林市磐石市
吉林市舒兰市公安局	吉林省吉林市舒兰市
吉林市龙潭区公安局	吉林省吉林市龙潭区
吉林市昌邑区公安局	吉林省吉林市昌邑区
吉林市蛟河市公安局	吉林省吉林市蛟河市
吉林市永吉县公安局	吉林省吉林市永吉县
吉林市桦甸市公安局	吉林省吉林市桦甸市
吉林市丰满区公安局	吉林省吉林市丰满区
吉林市吉林高新技术产业开发区公安局	吉林省吉林市吉林高新技术产业开发区
吉林市船营区公安局	吉林省吉林市船营区
延边朝鲜族自治州安图县公安局	吉林省延边朝鲜族自治州安图县
延边朝鲜族自治州龙井市公安局	吉林省延边朝鲜族自治州龙井市
延边朝鲜族自治州和龙市公安局	吉林省延边朝鲜族自治州和龙市
延边朝鲜族自治州汪清县公安局	吉林省延边朝鲜族自治州汪清县
延边朝鲜族自治州珲春市公安局	吉林省延边朝鲜族自治州珲春市
湖州市德清县公安局	浙江省湖州市德清县
湖州市安吉县公安局	浙江省湖州市安吉县
淮安市洪泽区公安局	江苏省淮安市洪泽区
淮安市清江浦区公安局	江苏省淮安市清江浦区
淮安市淮安区公安局	江苏省淮安市淮安区
淮安市盱眙县公安局	江苏省淮安市盱眙县
淮安市涟水县公安局	江苏省淮安市涟水县
淮安市淮安经济技术开发区公安局	江苏省淮安市淮安经济技术开发区
淮安市金湖县公安局	江苏省淮安市金湖县
淮安市淮阴区公安局	江苏省淮安市淮阴区
无锡市新吴区公安局	江苏省无锡市新吴区
无锡市滨湖区公安局	江苏省无锡市滨湖区
无锡市江阴市公安局	江苏省无锡市江阴市
无锡市锡山区公安局	江苏省无锡市锡山区
无锡市梁溪区公安局	江苏省无锡市梁溪区
无锡市惠山区公安局	江苏省无锡市惠山区
无锡市宜兴市公安局	江苏省无锡市宜兴市
常州市金坛区公安局	江苏省常州市金坛区
常州市武进区公安局	江苏省常州市武进区
常州市溧阳市公安局	江苏省常州市溧阳市
常州市天宁区公安局	江苏省常州市天宁区
常州市新北区公安局	江苏省常州市新北区
常州市钟楼区公安局	江苏省常州市钟楼区
连云港市东海县公安局	江苏省连云港市东海县
连云港市灌南县公安局	江苏省连云港市灌南县
连云港市赣榆区公安局	江苏省连云港市赣榆区
连云港市连云港经济技术开发区公安局	江苏省连云港市连云港经济技术开发区
连云港市连云港高新技术产业开发区公安局	江苏省连云港市连云港高新技术产业开发区
连云港市海州区公安局	江苏省连云港市海州区
连云港市连云区公安局	江苏省连云港市连云区
连云港市灌云县公安局	江苏省连云港市灌云县
扬州市宝应县公安局	江苏省扬州市宝应县
扬州市仪征市公安局	江苏省扬州市仪征市
扬州市广陵区公安局	江苏省扬州市广陵区
扬州市高邮市公安局	江苏省扬州市高邮市
扬州市江都区公安局	江苏省扬州市江都区
扬州市扬州经济技术开发区公安局	江苏省扬州市扬州经济技术开发区
扬州市邗江区公安局	江苏省扬州市邗江区
宿迁市泗阳县公安局	江苏省宿迁市泗阳县
宿迁市泗洪县公安局	江苏省宿迁市泗洪县
宿迁市宿迁经济技术开发区公安局	江苏省宿迁市宿迁经济技术开发区
宿迁市宿城区公安局	江苏省宿迁市宿城区
宿迁市沭阳县公安局	江苏省宿迁市沭阳县
宿迁市宿豫区公安局	江苏省宿迁市宿豫区
镇江市润州区公安局	江苏省镇江市润州区
镇江市丹阳市公安局	江苏省镇江市丹阳市
镇江市丹徒区公安局	江苏省镇江市丹徒区
镇江市扬中市公安局	江苏省镇江市扬中市
镇江市京口区公安局	江苏省镇江市京口区
镇江市镇江新区公安局	江苏省镇江市镇江新区
镇江市句容市公安局	江苏省镇江市句容市
盐城市盐都区公安局	江苏省盐城市盐都区
盐城市射阳县公安局	江苏省盐城市射阳县
盐城市建湖县公安局	江苏省盐城市建湖县
盐城市滨海县公安局	江苏省盐城市滨海县
盐城市阜宁县公安局	江苏省盐城市阜宁县
盐城市东台市公安局	江苏省盐城市东台市
盐城市大丰区公安局	江苏省盐城市大丰区
盐城市响水县公安局	江苏省盐城市响水县
盐城市盐城经济技术开发区公安局	江苏省盐城市盐城经济技术开发区
盐城市亭湖区公安局	江苏省盐城市亭湖区
南通市海门市公安局	江苏省南通市海门市
南通市港闸区公安局	江苏省南通市港闸区
南通市通州区公安局	江苏省南通市通州区
南通市如东县公安局	江苏省南通市如东县
南通市如皋市公安局	江苏省南通市如皋市
南通市崇川区公安局	江苏省南通市崇川区
南通市南通经济技术开发区公安局	江苏省南通市南通经济技术开发区
南通市海安市公安局	江苏省南通市海安市
南通市启东市公安局	江苏省南通市启东市
泰州市泰州医药高新技术产业开发区公安局	江苏省泰州市泰州医药高新技术产业开发区
泰州市靖江市公安局	江苏省泰州市靖江市
泰州市泰兴市公安局	江苏省泰州市泰兴市
泰州市海陵区公安局	江苏省泰州市海陵区
泰州市姜堰区公安局	江苏省泰州市姜堰区
泰州市高港区公安局	江苏省泰州市高港区
泰州市兴化市公安局	江苏省泰州市兴化市
南京市溧水区公安局	江苏省南京市溧水区
南京市栖霞区公安局	江苏省南京市栖霞区
南京市秦淮区公安局	江苏省南京市秦淮区
南京市江宁区公安局	江苏省南京市江宁区
南京市玄武区公安局	江苏省南京市玄武区
南京市建邺区公安局	江苏省南京市建邺区
南京市六合区公安局	江苏省南京市六合区
南京市雨花台区公安局	江苏省南京市雨花台区
南京市高淳区公安局	江苏省南京市高淳区
南京市鼓楼区公安局	江苏省南京市鼓楼区
南京市浦口区公安局	江苏省南京市浦口区
徐州市丰县公安局	江苏省徐州市丰县
徐州市睢宁县公安局	江苏省徐州市睢宁县
徐州市鼓楼区公安局	江苏省徐州市鼓楼区
徐州市云龙区公安局	江苏省徐州市云龙区
徐州市新沂市公安局	江苏省徐州市新沂市
徐州市泉山区公安局	江苏省徐州市泉山区
徐州市邳州市公安局	江苏省徐州市邳州市
徐州市贾汪区公安局	江苏省徐州市贾汪区
徐州市沛县公安局	江苏省徐州市沛县
徐州市铜山区公安局	江苏省徐州市铜山区
徐州市徐州经济技术开发区公安局	江苏省徐州市徐州经济技术开发区
苏州市吴中区公安局	江苏省苏州市吴中区
苏州市相城区公安局	江苏省苏州市相城区
苏州市张家港市公安局	江苏省苏州市张家港市
苏州市常熟市公安局	江苏省苏州市常熟市
苏州市太仓市公安局	江苏省苏州市太仓市
苏州市姑苏区公安局	江苏省苏州市姑苏区
苏州市苏州工业园区公安局	江苏省苏州市苏州工业园区
苏州市昆山市公安局	江苏省苏州市昆山市
苏州市虎丘区公安局	江苏省苏州市虎丘区
苏州市吴江区公安局	江苏省苏州市吴江区
日照市五莲县公安局	山东省日照市五莲县
日照市莒县公安局	山东省日照市莒县
日照市日照经济技术开发区公安局	山东省日照市日照经济技术开发区
日照市岚山区公安局	山东省日照市岚山区
日照市东港区公安局	山东省日照市东港区
滨州市博兴县公安局	山东省滨州市博兴县
滨州市滨城区公安局	山东省滨州市滨城区
滨州市邹平市公安局	山东省滨州市邹平市
滨州市惠民县公安局	山东省滨州市惠民县
滨州市阳信县公安局	山东省滨州市阳信县
滨州市沾化区公安局	山东省滨州市沾化区
滨州市无棣县公安局	山东省滨州市无棣县
泰安市岱岳区公安局	山东省泰安市岱岳区
泰安市泰山区公安局	山东省泰安市泰山区
泰安市宁阳县公安局	山东省泰安市宁阳县
泰安市肥城市公安局	山东省泰安市肥城市
泰安市东平县公安局	山东省泰安市东平县
泰安市新泰市公安局	山东省泰安市新泰市
枣庄市滕州市公安局	山东省枣庄市滕州市
枣庄市峄城区公安局	山东省枣庄市峄城区
枣庄市台儿庄区公安局	山东省枣庄市台儿庄区
枣庄市市中区公安局	山东省枣庄市市中区
枣庄市山亭区公安局	山东省枣庄市山亭区
枣庄市薛城区公安局	山东省枣庄市薛城区
菏泽市牡丹区公安局	山东省菏泽市牡丹区
菏泽市定陶区公安局	山东省菏泽市定陶区
菏泽市东明县公安局	山东省菏泽市东明县
菏泽市鄄城县公安局	山东省菏泽市鄄城县
菏泽市菏泽经济技术开发区公安局	山东省菏泽市菏泽经济技术开发区
菏泽市巨野县公安局	山东省菏泽市巨野县
菏泽市单县公安局	山东省菏泽市单县
菏泽市菏泽高新技术开发区公安局	山东省菏泽市菏泽高新技术开发区
菏泽市曹县公安局	山东省菏泽市曹县
菏泽市成武县公安局	山东省菏泽市成武县
菏泽市郓城县公安局	山东省菏泽市郓城县
济宁市邹城市公安局	山东省济宁市邹城市
济宁市嘉祥县公安局	山东省济宁市嘉祥县
济宁市金乡县公安局	山东省济宁市金乡县
济宁市曲阜市公安局	山东省济宁市曲阜市
济宁市任城区公安局	山东省济宁市任城区
济宁市泗水县公安局	山东省济宁市泗水县
济宁市济宁高新技术产业开发区公安局	山东省济宁市济宁高新技术产业开发区
济宁市梁山县公安局	山东省济宁市梁山县
济宁市鱼台县公安局	山东省济宁市鱼台县
济宁市汶上县公安局	山东省济宁市汶上县
济宁市微山县公安局	山东省济宁市微山县
济宁市兖州区公安局	山东省济宁市兖州区
聊城市莘县公安局	山东省聊城市莘县
聊城市临清市公安局	山东省聊城市临清市
聊城市冠县公安局	山东省聊城市冠县
聊城市高唐县公安局	山东省聊城市高唐县
聊城市东昌府区公安局	山东省聊城市东昌府区
聊城市阳谷县公安局	山东省聊城市阳谷县
聊城市茌平县公安局	山东省聊城市茌平县
聊城市东阿县公安局	山东省聊城市东阿县
潍坊市临朐县公安局	山东省潍坊市临朐县
潍坊市昌邑市公安局	山东省潍坊市昌邑市
潍坊市坊子区公安局	山东省潍坊市坊子区
潍坊市潍城区公安局	山东省潍坊市潍城区
潍坊市寒亭区公安局	山东省潍坊市寒亭区
潍坊市奎文区公安局	山东省潍坊市奎文区
潍坊市安丘市公安局	山东省潍坊市安丘市
潍坊市青州市公安局	山东省潍坊市青州市
潍坊市高密市公安局	山东省潍坊市高密市
潍坊市寿光市公安局	山东省潍坊市寿光市
潍坊市潍坊滨海经济技术开发区公安局	山东省潍坊市潍坊滨海经济技术开发区
潍坊市诸城市公安局	山东省潍坊市诸城市
潍坊市昌乐县公安局	山东省潍坊市昌乐县
济南市平阴县公安局	山东省济南市平阴县
济南市市中区公安局	山东省济南市市中区
济南市商河县公安局	山东省济南市商河县
济南市历下区公安局	山东省济南市历下区
济南市济阳区公安局	山东省济南市济阳区
济南市历城区公安局	山东省济南市历城区
济南市章丘区公安局	山东省济南市章丘区
济南市天桥区公安局	山东省济南市天桥区
济南市长清区公安局	山东省济南市长清区
济南市济南高新技术产业开发区公安局	山东省济南市济南高新技术产业开发区
济南市槐荫区公安局	山东省济南市槐荫区
莱芜市钢城区公安局	山东省莱芜市钢城区
莱芜市莱城区公安局	山东省莱芜市莱城区
青岛市李沧区公安局	山东省青岛市李沧区
青岛市青岛高新技术产业开发区公安局	山东省青岛市青岛高新技术产业开发区
青岛市胶州市公安局	山东省青岛市胶州市
青岛市莱西市公安局	山东省青岛市莱西市
青岛市即墨区公安局	山东省青岛市即墨区
青岛市市北区公安局	山东省青岛市市北区
青岛市黄岛区公安局	山东省青岛市黄岛区
青岛市崂山区公安局	山东省青岛市崂山区
青岛市城阳区公安局	山东省青岛市城阳区
青岛市平度市公安局	山东省青岛市平度市
青岛市市南区公安局	山东省青岛市市南区
东营市广饶县公安局	山东省东营市广饶县
东营市东营港经济开发区公安局	山东省东营市东营港经济开发区
东营市垦利区公安局	山东省东营市垦利区
东营市东营区公安局	山东省东营市东营区
东营市东营经济技术开发区公安局	山东省东营市东营经济技术开发区
东营市河口区公安局	山东省东营市河口区
东营市利津县公安局	山东省东营市利津县
临沂市费县公安局	山东省临沂市费县
临沂市临沂经济技术开发区公安局	山东省临沂市临沂经济技术开发区
临沂市临沭县公安局	山东省临沂市临沭县
临沂市蒙阴县公安局	山东省临沂市蒙阴县
临沂市临沂高新技术产业开发区公安局	山东省临沂市临沂高新技术产业开发区
临沂市罗庄区公安局	山东省临沂市罗庄区
临沂市平邑县公安局	山东省临沂市平邑县
临沂市莒南县公安局	山东省临沂市莒南县
临沂市郯城县公安局	山东省临沂市郯城县
临沂市兰陵县公安局	山东省临沂市兰陵县
临沂市临沂临港经济开发区公安局	山东省临沂市临沂临港经济开发区
临沂市兰山区公安局	山东省临沂市兰山区
临沂市河东区公安局	山东省临沂市河东区
临沂市沂水县公安局	山东省临沂市沂水县
临沂市沂南县公安局	山东省临沂市沂南县
德州市德州经济技术开发区公安局	山东省德州市德州经济技术开发区
德州市宁津县公安局	山东省德州市宁津县
德州市庆云县公安局	山东省德州市庆云县
德州市德城区公安局	山东省德州市德城区
德州市齐河县公安局	山东省德州市齐河县
德州市武城县公安局	山东省德州市武城县
德州市夏津县公安局	山东省德州市夏津县
德州市陵城区公安局	山东省德州市陵城区
德州市德州运河经济开发区公安局	山东省德州市德州运河经济开发区
德州市禹城市公安局	山东省德州市禹城市
德州市乐陵市公安局	山东省德州市乐陵市
德州市平原县公安局	山东省德州市平原县
德州市临邑县公安局	山东省德州市临邑县
淄博市桓台县公安局	山东省淄博市桓台县
淄博市高青县公安局	山东省淄博市高青县
淄博市临淄区公安局	山东省淄博市临淄区
淄博市沂源县公安局	山东省淄博市沂源县
淄博市周村区公安局	山东省淄博市周村区
淄博市张店区公安局	山东省淄博市张店区
淄博市博山区公安局	山东省淄博市博山区
淄博市淄川区公安局	山东省淄博市淄川区
威海市荣成市公安局	山东省威海市荣成市
威海市文登区公安局	山东省威海市文登区
威海市威海临港经济技术开发区公安局	山东省威海市威海临港经济技术开发区
威海市乳山市公安局	山东省威海市乳山市
威海市环翠区公安局	山东省威海市环翠区
威海市威海火炬高技术产业开发区公安局	山东省威海市威海火炬高技术产业开发区
威海市威海经济技术开发区公安局	山东省威海市威海经济技术开发区
烟台市烟台高新技术产业开发区公安局	山东省烟台市烟台高新技术产业开发区
烟台市长岛县公安局	山东省烟台市长岛县
烟台市莱山区公安局	山东省烟台市莱山区
烟台市烟台经济技术开发区公安局	山东省烟台市烟台经济技术开发区
烟台市栖霞市公安局	山东省烟台市栖霞市
烟台市芝罘区公安局	山东省烟台市芝罘区
烟台市牟平区公安局	山东省烟台市牟平区
烟台市招远市公安局	山东省烟台市招远市
烟台市蓬莱市公安局	山东省烟台市蓬莱市
烟台市龙口市公安局	山东省烟台市龙口市
烟台市莱州市公安局	山东省烟台市莱州市
烟台市海阳市公安局	山东省烟台市海阳市
烟台市福山区公安局	山东省烟台市福山区
烟台市莱阳市公安局	山东省烟台市莱阳市
包头市青山区公安局	内蒙古自治区包头市青山区
包头市包头稀土高新技术产业开发区公安局	内蒙古自治区包头市包头稀土高新技术产业开发区
包头市固阳县公安局	内蒙古自治区包头市固阳县
包头市达尔罕茂明安联合旗公安局	内蒙古自治区包头市达尔罕茂明安联合旗
包头市东河区公安局	内蒙古自治区包头市东河区
包头市白云鄂博矿区公安局	内蒙古自治区包头市白云鄂博矿区
包头市九原区公安局	内蒙古自治区包头市九原区
包头市昆都仑区公安局	内蒙古自治区包头市昆都仑区
包头市土默特右旗公安局	内蒙古自治区包头市土默特右旗
包头市石拐区公安局	内蒙古自治区包头市石拐区
锡林郭勒盟镶黄旗公安局	内蒙古自治区锡林郭勒盟镶黄旗
锡林郭勒盟东乌珠穆沁旗公安局	内蒙古自治区锡林郭勒盟东乌珠穆沁旗
锡林郭勒盟锡林浩特市公安局	内蒙古自治区锡林郭勒盟锡林浩特市
锡林郭勒盟乌拉盖管委会公安局	内蒙古自治区锡林郭勒盟乌拉盖管委会
锡林郭勒盟西乌珠穆沁旗公安局	内蒙古自治区锡林郭勒盟西乌珠穆沁旗
锡林郭勒盟二连浩特市公安局	内蒙古自治区锡林郭勒盟二连浩特市
锡林郭勒盟太仆寺旗公安局	内蒙古自治区锡林郭勒盟太仆寺旗
锡林郭勒盟苏尼特左旗公安局	内蒙古自治区锡林郭勒盟苏尼特左旗
锡林郭勒盟多伦县公安局	内蒙古自治区锡林郭勒盟多伦县
锡林郭勒盟苏尼特右旗公安局	内蒙古自治区锡林郭勒盟苏尼特右旗
锡林郭勒盟正镶白旗公安局	内蒙古自治区锡林郭勒盟正镶白旗
锡林郭勒盟正蓝旗公安局	内蒙古自治区锡林郭勒盟正蓝旗
锡林郭勒盟阿巴嘎旗公安局	内蒙古自治区锡林郭勒盟阿巴嘎旗
鄂尔多斯市东胜区公安局	内蒙古自治区鄂尔多斯市东胜区
鄂尔多斯市鄂托克旗公安局	内蒙古自治区鄂尔多斯市鄂托克旗
鄂尔多斯市乌审旗公安局	内蒙古自治区鄂尔多斯市乌审旗
鄂尔多斯市杭锦旗公安局	内蒙古自治区鄂尔多斯市杭锦旗
鄂尔多斯市伊金霍洛旗公安局	内蒙古自治区鄂尔多斯市伊金霍洛旗
鄂尔多斯市康巴什区公安局	内蒙古自治区鄂尔多斯市康巴什区
鄂尔多斯市鄂托克前旗公安局	内蒙古自治区鄂尔多斯市鄂托克前旗
鄂尔多斯市准格尔旗公安局	内蒙古自治区鄂尔多斯市准格尔旗
鄂尔多斯市达拉特旗公安局	内蒙古自治区鄂尔多斯市达拉特旗
巴彦淖尔市磴口县公安局	内蒙古自治区巴彦淖尔市磴口县
巴彦淖尔市临河区公安局	内蒙古自治区巴彦淖尔市临河区
巴彦淖尔市乌拉特前旗公安局	内蒙古自治区巴彦淖尔市乌拉特前旗
巴彦淖尔市杭锦后旗公安局	内蒙古自治区巴彦淖尔市杭锦后旗
巴彦淖尔市乌拉特中旗公安局	内蒙古自治区巴彦淖尔市乌拉特中旗
巴彦淖尔市五原县公安局	内蒙古自治区巴彦淖尔市五原县
巴彦淖尔市乌拉特后旗公安局	内蒙古自治区巴彦淖尔市乌拉特后旗
乌兰察布市丰镇市公安局	内蒙古自治区乌兰察布市丰镇市
乌兰察布市商都县公安局	内蒙古自治区乌兰察布市商都县
乌兰察布市化德县公安局	内蒙古自治区乌兰察布市化德县
乌兰察布市察哈尔右翼后旗公安局	内蒙古自治区乌兰察布市察哈尔右翼后旗
乌兰察布市察哈尔右翼中旗公安局	内蒙古自治区乌兰察布市察哈尔右翼中旗
乌兰察布市卓资县公安局	内蒙古自治区乌兰察布市卓资县
乌兰察布市兴和县公安局	内蒙古自治区乌兰察布市兴和县
乌兰察布市集宁区公安局	内蒙古自治区乌兰察布市集宁区
乌兰察布市凉城县公安局	内蒙古自治区乌兰察布市凉城县
乌兰察布市察哈尔右翼前旗公安局	内蒙古自治区乌兰察布市察哈尔右翼前旗
乌兰察布市四子王旗公安局	内蒙古自治区乌兰察布市四子王旗
赤峰市巴林右旗公安局	内蒙古自治区赤峰市巴林右旗
赤峰市翁牛特旗公安局	内蒙古自治区赤峰市翁牛特旗
赤峰市巴林左旗公安局	内蒙古自治区赤峰市巴林左旗
赤峰市敖汉旗公安局	内蒙古自治区赤峰市敖汉旗
赤峰市红山区公安局	内蒙古自治区赤峰市红山区
赤峰市宁城县公安局	内蒙古自治区赤峰市宁城县
赤峰市喀喇沁旗公安局	内蒙古自治区赤峰市喀喇沁旗
赤峰市元宝山区公安局	内蒙古自治区赤峰市元宝山区
赤峰市克什克腾旗公安局	内蒙古自治区赤峰市克什克腾旗
赤峰市林西县公安局	内蒙古自治区赤峰市林西县
赤峰市松山区公安局	内蒙古自治区赤峰市松山区
赤峰市阿鲁科尔沁旗公安局	内蒙古自治区赤峰市阿鲁科尔沁旗
兴安盟突泉县公安局	内蒙古自治区兴安盟突泉县
兴安盟阿尔山市公安局	内蒙古自治区兴安盟阿尔山市
兴安盟乌兰浩特市公安局	内蒙古自治区兴安盟乌兰浩特市
兴安盟科尔沁右翼前旗公安局	内蒙古自治区兴安盟科尔沁右翼前旗
兴安盟扎赉特旗公安局	内蒙古自治区兴安盟扎赉特旗
兴安盟科尔沁右翼中旗公安局	内蒙古自治区兴安盟科尔沁右翼中旗
呼和浩特市呼和浩特金海工业园区公安局	内蒙古自治区呼和浩特市呼和浩特金海工业园区
呼和浩特市清水河县公安局	内蒙古自治区呼和浩特市清水河县
呼和浩特市呼和浩特经济技术开发区公安局	内蒙古自治区呼和浩特市呼和浩特经济技术开发区
呼和浩特市回民区公安局	内蒙古自治区呼和浩特市回民区
呼和浩特市土默特左旗公安局	内蒙古自治区呼和浩特市土默特左旗
呼和浩特市新城区公安局	内蒙古自治区呼和浩特市新城区
呼和浩特市赛罕区公安局	内蒙古自治区呼和浩特市赛罕区
呼和浩特市武川县公安局	内蒙古自治区呼和浩特市武川县
呼和浩特市托克托县公安局	内蒙古自治区呼和浩特市托克托县
呼和浩特市和林格尔县公安局	内蒙古自治区呼和浩特市和林格尔县
呼和浩特市玉泉区公安局	内蒙古自治区呼和浩特市玉泉区
呼伦贝尔市鄂温克族自治旗公安局	内蒙古自治区呼伦贝尔市鄂温克族自治旗
呼伦贝尔市扎兰屯市公安局	内蒙古自治区呼伦贝尔市扎兰屯市
呼伦贝尔市新巴尔虎左旗公安局	内蒙古自治区呼伦贝尔市新巴尔虎左旗
呼伦贝尔市满洲里市公安局	内蒙古自治区呼伦贝尔市满洲里市
呼伦贝尔市莫力达瓦达斡尔族自治旗公安局	内蒙古自治区呼伦贝尔市莫力达瓦达斡尔族自治旗
呼伦贝尔市阿荣旗公安局	内蒙古自治区呼伦贝尔市阿荣旗
呼伦贝尔市鄂伦春自治旗公安局	内蒙古自治区呼伦贝尔市鄂伦春自治旗
固原市泾源县公安局	宁夏回族自治区固原市泾源县
固原市彭阳县公安局	宁夏回族自治区固原市彭阳县
固原市原州区公安局	宁夏回族自治区固原市原州区
固原市隆德县公安局	宁夏回族自治区固原市隆德县
固原市西吉县公安局	宁夏回族自治区固原市西吉县
吴忠市盐池县公安局	宁夏回族自治区吴忠市盐池县
吴忠市同心县公安局	宁夏回族自治区吴忠市同心县
吴忠市青铜峡市公安局	宁夏回族自治区吴忠市青铜峡市
吴忠市利通区公安局	宁夏回族自治区吴忠市利通区
湘潭市湘潭县公安局	湖南省湘潭市湘潭县
湘潭市雨湖区公安局	湖南省湘潭市雨湖区
湘潭市韶山市公安局	湖南省湘潭市韶山市
湘潭市湘乡市公安局	湖南省湘潭市湘乡市
湘潭市湘潭昭山示范区公安局	湖南省湘潭市湘潭昭山示范区
湘潭市岳塘区公安局	湖南省湘潭市岳塘区
湘潭市湘潭九华示范区公安局	湖南省湘潭市湘潭九华示范区
湘潭市湖南湘潭高新技术产业园区公安局	湖南省湘潭市湖南湘潭高新技术产业园区
岳阳市岳阳市屈原管理区公安局	湖南省岳阳市岳阳市屈原管理区
岳阳市岳阳楼区公安局	湖南省岳阳市岳阳楼区
岳阳市平江县公安局	湖南省岳阳市平江县
岳阳市临湘市公安局	湖南省岳阳市临湘市
岳阳市岳阳县公安局	湖南省岳阳市岳阳县
岳阳市华容县公安局	湖南省岳阳市华容县
岳阳市湘阴县公安局	湖南省岳阳市湘阴县
岳阳市君山区公安局	湖南省岳阳市君山区
岳阳市汨罗市公安局	湖南省岳阳市汨罗市
岳阳市云溪区公安局	湖南省岳阳市云溪区
湘西土家族苗族自治州吉首市公安局	湖南省湘西土家族苗族自治州吉首市
湘西土家族苗族自治州永顺县公安局	湖南省湘西土家族苗族自治州永顺县
湘西土家族苗族自治州古丈县公安局	湖南省湘西土家族苗族自治州古丈县
湘西土家族苗族自治州湖南永顺经济开发区公安局	湖南省湘西土家族苗族自治州湖南永顺经济开发区
湘西土家族苗族自治州泸溪县公安局	湖南省湘西土家族苗族自治州泸溪县
湘西土家族苗族自治州凤凰县公安局	湖南省湘西土家族苗族自治州凤凰县
湘西土家族苗族自治州花垣县公安局	湖南省湘西土家族苗族自治州花垣县
湘西土家族苗族自治州保靖县公安局	湖南省湘西土家族苗族自治州保靖县
湘西土家族苗族自治州湖南吉首经济开发区公安局	湖南省湘西土家族苗族自治州湖南吉首经济开发区
湘西土家族苗族自治州龙山县公安局	湖南省湘西土家族苗族自治州龙山县
郴州市汝城县公安局	湖南省郴州市汝城县
郴州市安仁县公安局	湖南省郴州市安仁县
郴州市桂东县公安局	湖南省郴州市桂东县
郴州市临武县公安局	湖南省郴州市临武县
郴州市桂阳县公安局	湖南省郴州市桂阳县
郴州市资兴市公安局	湖南省郴州市资兴市
郴州市北湖区公安局	湖南省郴州市北湖区
郴州市宜章县公安局	湖南省郴州市宜章县
郴州市苏仙区公安局	湖南省郴州市苏仙区
郴州市永兴县公安局	湖南省郴州市永兴县
郴州市嘉禾县公安局	湖南省郴州市嘉禾县
常德市常德市西洞庭管理区公安局	湖南省常德市常德市西洞庭管理区
常德市武陵区公安局	湖南省常德市武陵区
常德市津市市公安局	湖南省常德市津市市
常德市鼎城区公安局	湖南省常德市鼎城区
常德市桃源县公安局	湖南省常德市桃源县
常德市安乡县公安局	湖南省常德市安乡县
常德市石门县公安局	湖南省常德市石门县
常德市汉寿县公安局	湖南省常德市汉寿县
常德市临澧县公安局	湖南省常德市临澧县
常德市澧县公安局	湖南省常德市澧县
衡阳市珠晖区公安局	湖南省衡阳市珠晖区
衡阳市湖南衡阳松木经济开发区公安局	湖南省衡阳市湖南衡阳松木经济开发区
衡阳市雁峰区公安局	湖南省衡阳市雁峰区
衡阳市耒阳市公安局	湖南省衡阳市耒阳市
衡阳市常宁市公安局	湖南省衡阳市常宁市
衡阳市南岳区公安局	湖南省衡阳市南岳区
衡阳市湖南衡阳高新技术产业园区公安局	湖南省衡阳市湖南衡阳高新技术产业园区
衡阳市衡阳综合保税区公安局	湖南省衡阳市衡阳综合保税区
衡阳市衡阳县公安局	湖南省衡阳市衡阳县
衡阳市衡东县公安局	湖南省衡阳市衡东县
衡阳市石鼓区公安局	湖南省衡阳市石鼓区
衡阳市祁东县公安局	湖南省衡阳市祁东县
衡阳市衡山县公安局	湖南省衡阳市衡山县
衡阳市蒸湘区公安局	湖南省衡阳市蒸湘区
衡阳市衡南县公安局	湖南省衡阳市衡南县
娄底市冷水江市公安局	湖南省娄底市冷水江市
娄底市新化县公安局	湖南省娄底市新化县
娄底市娄星区公安局	湖南省娄底市娄星区
娄底市双峰县公安局	湖南省娄底市双峰县
娄底市涟源市公安局	湖南省娄底市涟源市
益阳市湖南益阳高新技术产业园区公安局	湖南省益阳市湖南益阳高新技术产业园区
益阳市资阳区公安局	湖南省益阳市资阳区
益阳市桃江县公安局	湖南省益阳市桃江县
益阳市沅江市公安局	湖南省益阳市沅江市
益阳市南县公安局	湖南省益阳市南县
益阳市益阳市大通湖管理区公安局	湖南省益阳市益阳市大通湖管理区
益阳市安化县公安局	湖南省益阳市安化县
益阳市赫山区公安局	湖南省益阳市赫山区
张家界市永定区公安局	湖南省张家界市永定区
张家界市桑植县公安局	湖南省张家界市桑植县
张家界市武陵源区公安局	湖南省张家界市武陵源区
张家界市慈利县公安局	湖南省张家界市慈利县
株洲市炎陵县公安局	湖南省株洲市炎陵县
株洲市茶陵县公安局	湖南省株洲市茶陵县
株洲市石峰区公安局	湖南省株洲市石峰区
株洲市云龙示范区公安局	湖南省株洲市云龙示范区
株洲市荷塘区公安局	湖南省株洲市荷塘区
株洲市渌口区公安局	湖南省株洲市渌口区
株洲市芦淞区公安局	湖南省株洲市芦淞区
株洲市攸县公安局	湖南省株洲市攸县
株洲市醴陵市公安局	湖南省株洲市醴陵市
株洲市天元区公安局	湖南省株洲市天元区
邵阳市邵东县公安局	湖南省邵阳市邵东县
邵阳市新邵县公安局	湖南省邵阳市新邵县
邵阳市北塔区公安局	湖南省邵阳市北塔区
邵阳市洞口县公安局	湖南省邵阳市洞口县
邵阳市双清区公安局	湖南省邵阳市双清区
邵阳市邵阳县公安局	湖南省邵阳市邵阳县
邵阳市绥宁县公安局	湖南省邵阳市绥宁县
邵阳市隆回县公安局	湖南省邵阳市隆回县
邵阳市新宁县公安局	湖南省邵阳市新宁县
邵阳市大祥区公安局	湖南省邵阳市大祥区
邵阳市武冈市公安局	湖南省邵阳市武冈市
邵阳市城步苗族自治县公安局	湖南省邵阳市城步苗族自治县
长沙市浏阳市公安局	湖南省长沙市浏阳市
长沙市岳麓区公安局	湖南省长沙市岳麓区
长沙市开福区公安局	湖南省长沙市开福区
长沙市芙蓉区公安局	湖南省长沙市芙蓉区
长沙市雨花区公安局	湖南省长沙市雨花区
长沙市望城区公安局	湖南省长沙市望城区
长沙市宁乡市公安局	湖南省长沙市宁乡市
长沙市长沙县公安局	湖南省长沙市长沙县
长沙市天心区公安局	湖南省长沙市天心区
永州市新田县公安局	湖南省永州市新田县
永州市蓝山县公安局	湖南省永州市蓝山县
永州市江永县公安局	湖南省永州市江永县
永州市祁阳县公安局	湖南省永州市祁阳县
永州市东安县公安局	湖南省永州市东安县
永州市双牌县公安局	湖南省永州市双牌县
永州市冷水滩区公安局	湖南省永州市冷水滩区
永州市零陵区公安局	湖南省永州市零陵区
永州市道县公安局	湖南省永州市道县
永州市永州经济技术开发区公安局	湖南省永州市永州经济技术开发区
永州市宁远县公安局	湖南省永州市宁远县
永州市江华瑶族自治县公安局	湖南省永州市江华瑶族自治县
永州市永州市金洞管理区公安局	湖南省永州市永州市金洞管理区
永州市永州市回龙圩管理区公安局	湖南省永州市永州市回龙圩管理区
怀化市会同县公安局	湖南省怀化市会同县
怀化市中方县公安局	湖南省怀化市中方县
怀化市新晃侗族自治县公安局	湖南省怀化市新晃侗族自治县
怀化市沅陵县公安局	湖南省怀化市沅陵县
怀化市芷江侗族自治县公安局	湖南省怀化市芷江侗族自治县
怀化市麻阳苗族自治县公安局	湖南省怀化市麻阳苗族自治县
怀化市怀化市洪江管理区公安局	湖南省怀化市怀化市洪江管理区
怀化市溆浦县公安局	湖南省怀化市溆浦县
怀化市靖州苗族侗族自治县公安局	湖南省怀化市靖州苗族侗族自治县
怀化市辰溪县公安局	湖南省怀化市辰溪县
怀化市通道侗族自治县公安局	湖南省怀化市通道侗族自治县
怀化市洪江市公安局	湖南省怀化市洪江市
怀化市鹤城区公安局	湖南省怀化市鹤城区
盘锦市双台子区公安局	辽宁省盘锦市双台子区
盘锦市大洼区公安局	辽宁省盘锦市大洼区
盘锦市兴隆台区公安局	辽宁省盘锦市兴隆台区
盘锦市盘山县公安局	辽宁省盘锦市盘山县
葫芦岛市兴城市公安局	辽宁省葫芦岛市兴城市
葫芦岛市连山区公安局	辽宁省葫芦岛市连山区
葫芦岛市龙港区公安局	辽宁省葫芦岛市龙港区
葫芦岛市南票区公安局	辽宁省葫芦岛市南票区
葫芦岛市绥中县公安局	辽宁省葫芦岛市绥中县
葫芦岛市建昌县公安局	辽宁省葫芦岛市建昌县
丹东市东港市公安局	辽宁省丹东市东港市
丹东市振兴区公安局	辽宁省丹东市振兴区
丹东市凤城市公安局	辽宁省丹东市凤城市
丹东市元宝区公安局	辽宁省丹东市元宝区
丹东市振安区公安局	辽宁省丹东市振安区
丹东市宽甸满族自治县公安局	辽宁省丹东市宽甸满族自治县
本溪市本溪满族自治县公安局	辽宁省本溪市本溪满族自治县
本溪市溪湖区公安局	辽宁省本溪市溪湖区
本溪市平山区公安局	辽宁省本溪市平山区
本溪市明山区公安局	辽宁省本溪市明山区
本溪市南芬区公安局	辽宁省本溪市南芬区
本溪市桓仁满族自治县公安局	辽宁省本溪市桓仁满族自治县
大连市中山区公安局	辽宁省大连市中山区
大连市旅顺口区公安局	辽宁省大连市旅顺口区
大连市沙河口区公安局	辽宁省大连市沙河口区
大连市长海县公安局	辽宁省大连市长海县
大连市西岗区公安局	辽宁省大连市西岗区
大连市庄河市公安局	辽宁省大连市庄河市
大连市普兰店区公安局	辽宁省大连市普兰店区
大连市甘井子区公安局	辽宁省大连市甘井子区
大连市金州区公安局	辽宁省大连市金州区
大连市瓦房店市公安局	辽宁省大连市瓦房店市
铁岭市铁岭县公安局	辽宁省铁岭市铁岭县
铁岭市银州区公安局	辽宁省铁岭市银州区
铁岭市开原市公安局	辽宁省铁岭市开原市
铁岭市清河区公安局	辽宁省铁岭市清河区
铁岭市调兵山市公安局	辽宁省铁岭市调兵山市
铁岭市西丰县公安局	辽宁省铁岭市西丰县
铁岭市昌图县公安局	辽宁省铁岭市昌图县
抚顺市顺城区公安局	辽宁省抚顺市顺城区
抚顺市望花区公安局	辽宁省抚顺市望花区
抚顺市抚顺县公安局	辽宁省抚顺市抚顺县
抚顺市清原满族自治县公安局	辽宁省抚顺市清原满族自治县
抚顺市新宾满族自治县公安局	辽宁省抚顺市新宾满族自治县
抚顺市东洲区公安局	辽宁省抚顺市东洲区
抚顺市新抚区公安局	辽宁省抚顺市新抚区
鞍山市千山区公安局	辽宁省鞍山市千山区
鞍山市立山区公安局	辽宁省鞍山市立山区
鞍山市海城市公安局	辽宁省鞍山市海城市
鞍山市台安县公安局	辽宁省鞍山市台安县
鞍山市铁西区公安局	辽宁省鞍山市铁西区
鞍山市岫岩满族自治县公安局	辽宁省鞍山市岫岩满族自治县
鞍山市铁东区公安局	辽宁省鞍山市铁东区
锦州市太和区公安局	辽宁省锦州市太和区
锦州市凌海市公安局	辽宁省锦州市凌海市
锦州市古塔区公安局	辽宁省锦州市古塔区
锦州市义县公安局	辽宁省锦州市义县
锦州市黑山县公安局	辽宁省锦州市黑山县
锦州市凌河区公安局	辽宁省锦州市凌河区
锦州市北镇市公安局	辽宁省锦州市北镇市
沈阳市沈北新区公安局	辽宁省沈阳市沈北新区
沈阳市辽中区公安局	辽宁省沈阳市辽中区
沈阳市新民市公安局	辽宁省沈阳市新民市
沈阳市和平区公安局	辽宁省沈阳市和平区
沈阳市大东区公安局	辽宁省沈阳市大东区
沈阳市法库县公安局	辽宁省沈阳市法库县
沈阳市于洪区公安局	辽宁省沈阳市于洪区
沈阳市康平县公安局	辽宁省沈阳市康平县
沈阳市苏家屯区公安局	辽宁省沈阳市苏家屯区
沈阳市浑南区公安局	辽宁省沈阳市浑南区
沈阳市铁西区公安局	辽宁省沈阳市铁西区
沈阳市沈河区公安局	辽宁省沈阳市沈河区
沈阳市皇姑区公安局	辽宁省沈阳市皇姑区
营口市西市区公安局	辽宁省营口市西市区
营口市盖州市公安局	辽宁省营口市盖州市
营口市老边区公安局	辽宁省营口市老边区
营口市鲅鱼圈区公安局	辽宁省营口市鲅鱼圈区
营口市大石桥市公安局	辽宁省营口市大石桥市
营口市站前区公安局	辽宁省营口市站前区
阜新市新邱区公安局	辽宁省阜新市新邱区
阜新市细河区公安局	辽宁省阜新市细河区
阜新市海州区公安局	辽宁省阜新市海州区
阜新市阜新蒙古族自治县公安局	辽宁省阜新市阜新蒙古族自治县
阜新市彰武县公安局	辽宁省阜新市彰武县
阜新市太平区公安局	辽宁省阜新市太平区
阜新市清河门区公安局	辽宁省阜新市清河门区
朝阳市朝阳县公安局	辽宁省朝阳市朝阳县
朝阳市喀喇沁左翼蒙古族自治县公安局	辽宁省朝阳市喀喇沁左翼蒙古族自治县
朝阳市龙城区公安局	辽宁省朝阳市龙城区
朝阳市建平县公安局	辽宁省朝阳市建平县
朝阳市北票市公安局	辽宁省朝阳市北票市
朝阳市凌源市公安局	辽宁省朝阳市凌源市
朝阳市双塔区公安局	辽宁省朝阳市双塔区
辽阳市文圣区公安局	辽宁省辽阳市文圣区
辽阳市宏伟区公安局	辽宁省辽阳市宏伟区
辽阳市辽阳县公安局	辽宁省辽阳市辽阳县
辽阳市太子河区公安局	辽宁省辽阳市太子河区
辽阳市弓长岭区公安局	辽宁省辽阳市弓长岭区
辽阳市灯塔市公安局	辽宁省辽阳市灯塔市
辽阳市白塔区公安局	辽宁省辽阳市白塔区
贵港市港北区公安局	广西壮族自治区贵港市港北区
贵港市平南县公安局	广西壮族自治区贵港市平南县
贵港市港南区公安局	广西壮族自治区贵港市港南区
贵港市覃塘区公安局	广西壮族自治区贵港市覃塘区
贵港市桂平市公安局	广西壮族自治区贵港市桂平市
来宾市兴宾区公安局	广西壮族自治区来宾市兴宾区
来宾市武宣县公安局	广西壮族自治区来宾市武宣县
来宾市合山市公安局	广西壮族自治区来宾市合山市
来宾市忻城县公安局	广西壮族自治区来宾市忻城县
来宾市金秀瑶族自治县公安局	广西壮族自治区来宾市金秀瑶族自治县
来宾市象州县公安局	广西壮族自治区来宾市象州县
梧州市龙圩区公安局	广西壮族自治区梧州市龙圩区
梧州市蒙山县公安局	广西壮族自治区梧州市蒙山县
梧州市万秀区公安局	广西壮族自治区梧州市万秀区
梧州市岑溪市公安局	广西壮族自治区梧州市岑溪市
梧州市苍梧县公安局	广西壮族自治区梧州市苍梧县
梧州市藤县公安局	广西壮族自治区梧州市藤县
梧州市长洲区公安局	广西壮族自治区梧州市长洲区
贺州市富川瑶族自治县公安局	广西壮族自治区贺州市富川瑶族自治县
贺州市昭平县公安局	广西壮族自治区贺州市昭平县
市辖区南开区公安局	天津市市辖区南开区
市辖区北辰区公安局	天津市市辖区北辰区
市辖区红桥区公安局	天津市市辖区红桥区
市辖区东丽区公安局	天津市市辖区东丽区
市辖区滨海新区公安局	天津市市辖区滨海新区
市辖区宝坻区公安局	天津市市辖区宝坻区
市辖区津南区公安局	天津市市辖区津南区
市辖区静海区公安局	天津市市辖区静海区
市辖区蓟州区公安局	天津市市辖区蓟州区
市辖区河东区公安局	天津市市辖区河东区
市辖区武清区公安局	天津市市辖区武清区
市辖区河北区公安局	天津市市辖区河北区
市辖区和平区公安局	天津市市辖区和平区
市辖区河西区公安局	天津市市辖区河西区
市辖区西青区公安局	天津市市辖区西青区
市辖区宁河区公安局	天津市市辖区宁河区
湖州市南浔区公安局	浙江省湖州市南浔区
湖州市长兴县公安局	浙江省湖州市长兴县
湖州市吴兴区公安局	浙江省湖州市吴兴区
杭州市富阳区公安局	浙江省杭州市富阳区
杭州市拱墅区公安局	浙江省杭州市拱墅区
杭州市建德市公安局	浙江省杭州市建德市
杭州市下城区公安局	浙江省杭州市下城区
杭州市江干区公安局	浙江省杭州市江干区
杭州市滨江区公安局	浙江省杭州市滨江区
杭州市上城区公安局	浙江省杭州市上城区
杭州市临安区公安局	浙江省杭州市临安区
杭州市桐庐县公安局	浙江省杭州市桐庐县
杭州市萧山区公安局	浙江省杭州市萧山区
杭州市淳安县公安局	浙江省杭州市淳安县
杭州市西湖区公安局	浙江省杭州市西湖区
杭州市余杭区公安局	浙江省杭州市余杭区
绍兴市柯桥区公安局	浙江省绍兴市柯桥区
绍兴市越城区公安局	浙江省绍兴市越城区
绍兴市诸暨市公安局	浙江省绍兴市诸暨市
绍兴市嵊州市公安局	浙江省绍兴市嵊州市
绍兴市新昌县公安局	浙江省绍兴市新昌县
绍兴市上虞区公安局	浙江省绍兴市上虞区
台州市仙居县公安局	浙江省台州市仙居县
台州市黄岩区公安局	浙江省台州市黄岩区
台州市温岭市公安局	浙江省台州市温岭市
台州市三门县公安局	浙江省台州市三门县
台州市玉环市公安局	浙江省台州市玉环市
台州市路桥区公安局	浙江省台州市路桥区
台州市天台县公安局	浙江省台州市天台县
台州市临海市公安局	浙江省台州市临海市
台州市椒江区公安局	浙江省台州市椒江区
舟山市岱山县公安局	浙江省舟山市岱山县
舟山市嵊泗县公安局	浙江省舟山市嵊泗县
舟山市普陀区公安局	浙江省舟山市普陀区
舟山市定海区公安局	浙江省舟山市定海区
衢州市龙游县公安局	浙江省衢州市龙游县
衢州市江山市公安局	浙江省衢州市江山市
衢州市衢江区公安局	浙江省衢州市衢江区
衢州市柯城区公安局	浙江省衢州市柯城区
衢州市开化县公安局	浙江省衢州市开化县
衢州市常山县公安局	浙江省衢州市常山县
宁波市镇海区公安局	浙江省宁波市镇海区
宁波市宁海县公安局	浙江省宁波市宁海县
宁波市余姚市公安局	浙江省宁波市余姚市
宁波市海曙区公安局	浙江省宁波市海曙区
宁波市奉化区公安局	浙江省宁波市奉化区
宁波市北仑区公安局	浙江省宁波市北仑区
宁波市慈溪市公安局	浙江省宁波市慈溪市
宁波市鄞州区公安局	浙江省宁波市鄞州区
宁波市江北区公安局	浙江省宁波市江北区
宁波市象山县公安局	浙江省宁波市象山县
温州市文成县公安局	浙江省温州市文成县
温州市瓯海区公安局	浙江省温州市瓯海区
温州市鹿城区公安局	浙江省温州市鹿城区
温州市乐清市公安局	浙江省温州市乐清市
温州市龙湾区公安局	浙江省温州市龙湾区
温州市瑞安市公安局	浙江省温州市瑞安市
温州市苍南县公安局	浙江省温州市苍南县
温州市永嘉县公安局	浙江省温州市永嘉县
温州市温州经济技术开发区公安局	浙江省温州市温州经济技术开发区
温州市洞头区公安局	浙江省温州市洞头区
温州市泰顺县公安局	浙江省温州市泰顺县
温州市平阳县公安局	浙江省温州市平阳县
金华市婺城区公安局	浙江省金华市婺城区
金华市兰溪市公安局	浙江省金华市兰溪市
金华市武义县公安局	浙江省金华市武义县
金华市金东区公安局	浙江省金华市金东区
金华市东阳市公安局	浙江省金华市东阳市
金华市永康市公安局	浙江省金华市永康市
金华市浦江县公安局	浙江省金华市浦江县
金华市义乌市公安局	浙江省金华市义乌市
金华市磐安县公安局	浙江省金华市磐安县
丽水市庆元县公安局	浙江省丽水市庆元县
丽水市缙云县公安局	浙江省丽水市缙云县
丽水市莲都区公安局	浙江省丽水市莲都区
丽水市青田县公安局	浙江省丽水市青田县
丽水市松阳县公安局	浙江省丽水市松阳县
丽水市景宁畲族自治县公安局	浙江省丽水市景宁畲族自治县
丽水市遂昌县公安局	浙江省丽水市遂昌县
丽水市云和县公安局	浙江省丽水市云和县
丽水市龙泉市公安局	浙江省丽水市龙泉市
嘉兴市平湖市公安局	浙江省嘉兴市平湖市
嘉兴市南湖区公安局	浙江省嘉兴市南湖区
嘉兴市秀洲区公安局	浙江省嘉兴市秀洲区
嘉兴市嘉善县公安局	浙江省嘉兴市嘉善县
嘉兴市桐乡市公安局	浙江省嘉兴市桐乡市
嘉兴市海宁市公安局	浙江省嘉兴市海宁市
嘉兴市海盐县公安局	浙江省嘉兴市海盐县
昌都市边坝县公安局	西藏自治区昌都市边坝县
昌都市卡若区公安局	西藏自治区昌都市卡若区
昌都市芒康县公安局	西藏自治区昌都市芒康县
昌都市察雅县公安局	西藏自治区昌都市察雅县
昌都市八宿县公安局	西藏自治区昌都市八宿县
昌都市贡觉县公安局	西藏自治区昌都市贡觉县
昌都市江达县公安局	西藏自治区昌都市江达县
昌都市洛隆县公安局	西藏自治区昌都市洛隆县
昌都市左贡县公安局	西藏自治区昌都市左贡县
昌都市类乌齐县公安局	西藏自治区昌都市类乌齐县
昌都市丁青县公安局	西藏自治区昌都市丁青县
拉萨市西藏文化旅游创意园区公安局	西藏自治区拉萨市西藏文化旅游创意园区
拉萨市城关区公安局	西藏自治区拉萨市城关区
拉萨市达孜区公安局	西藏自治区拉萨市达孜区
拉萨市堆龙德庆区公安局	西藏自治区拉萨市堆龙德庆区
拉萨市曲水县公安局	西藏自治区拉萨市曲水县
拉萨市格尔木藏青工业园区公安局	西藏自治区拉萨市格尔木藏青工业园区
拉萨市尼木县公安局	西藏自治区拉萨市尼木县
拉萨市墨竹工卡县公安局	西藏自治区拉萨市墨竹工卡县
拉萨市拉萨经济技术开发区公安局	西藏自治区拉萨市拉萨经济技术开发区
拉萨市当雄县公安局	西藏自治区拉萨市当雄县
拉萨市达孜工业园区公安局	西藏自治区拉萨市达孜工业园区
拉萨市林周县公安局	西藏自治区拉萨市林周县
山南市桑日县公安局	西藏自治区山南市桑日县
山南市加查县公安局	西藏自治区山南市加查县
山南市浪卡子县公安局	西藏自治区山南市浪卡子县
山南市贡嘎县公安局	西藏自治区山南市贡嘎县
山南市措美县公安局	西藏自治区山南市措美县
山南市错那县公安局	西藏自治区山南市错那县
山南市扎囊县公安局	西藏自治区山南市扎囊县
山南市洛扎县公安局	西藏自治区山南市洛扎县
山南市琼结县公安局	西藏自治区山南市琼结县
山南市曲松县公安局	西藏自治区山南市曲松县
山南市隆子县公安局	西藏自治区山南市隆子县
山南市乃东区公安局	西藏自治区山南市乃东区
阿里地区札达县公安局	西藏自治区阿里地区札达县
阿里地区噶尔县公安局	西藏自治区阿里地区噶尔县
阿里地区改则县公安局	西藏自治区阿里地区改则县
阿里地区革吉县公安局	西藏自治区阿里地区革吉县
阿里地区普兰县公安局	西藏自治区阿里地区普兰县
阿里地区措勤县公安局	西藏自治区阿里地区措勤县
阿里地区日土县公安局	西藏自治区阿里地区日土县
那曲市聂荣县公安局	西藏自治区那曲市聂荣县
那曲市安多县公安局	西藏自治区那曲市安多县
那曲市比如县公安局	西藏自治区那曲市比如县
那曲市申扎县公安局	西藏自治区那曲市申扎县
那曲市巴青县公安局	西藏自治区那曲市巴青县
那曲市尼玛县公安局	西藏自治区那曲市尼玛县
那曲市双湖县公安局	西藏自治区那曲市双湖县
那曲市嘉黎县公安局	西藏自治区那曲市嘉黎县
那曲市班戈县公安局	西藏自治区那曲市班戈县
那曲市色尼区公安局	西藏自治区那曲市色尼区
那曲市索县公安局	西藏自治区那曲市索县
日喀则市江孜县公安局	西藏自治区日喀则市江孜县
日喀则市定日县公安局	西藏自治区日喀则市定日县
日喀则市南木林县公安局	西藏自治区日喀则市南木林县
日喀则市萨迦县公安局	西藏自治区日喀则市萨迦县
日喀则市谢通门县公安局	西藏自治区日喀则市谢通门县
日喀则市仲巴县公安局	西藏自治区日喀则市仲巴县
日喀则市亚东县公安局	西藏自治区日喀则市亚东县
日喀则市吉隆县公安局	西藏自治区日喀则市吉隆县
日喀则市萨嘎县公安局	西藏自治区日喀则市萨嘎县
日喀则市昂仁县公安局	西藏自治区日喀则市昂仁县
日喀则市拉孜县公安局	西藏自治区日喀则市拉孜县
日喀则市康马县公安局	西藏自治区日喀则市康马县
日喀则市白朗县公安局	西藏自治区日喀则市白朗县
日喀则市岗巴县公安局	西藏自治区日喀则市岗巴县
日喀则市桑珠孜区公安局	西藏自治区日喀则市桑珠孜区
日喀则市定结县公安局	西藏自治区日喀则市定结县
日喀则市聂拉木县公安局	西藏自治区日喀则市聂拉木县
日喀则市仁布县公安局	西藏自治区日喀则市仁布县
林芝市工布江达县公安局	西藏自治区林芝市工布江达县
林芝市墨脱县公安局	西藏自治区林芝市墨脱县
林芝市察隅县公安局	西藏自治区林芝市察隅县
林芝市波密县公安局	西藏自治区林芝市波密县
林芝市巴宜区公安局	西藏自治区林芝市巴宜区
林芝市朗县公安局	西藏自治区林芝市朗县
林芝市米林县公安局	西藏自治区林芝市米林县
抚州市南城县公安局	江西省抚州市南城县
抚州市金溪县公安局	江西省抚州市金溪县
抚州市乐安县公安局	江西省抚州市乐安县
抚州市广昌县公安局	江西省抚州市广昌县
抚州市资溪县公安局	江西省抚州市资溪县
抚州市南丰县公安局	江西省抚州市南丰县
抚州市东乡区公安局	江西省抚州市东乡区
抚州市崇仁县公安局	江西省抚州市崇仁县
抚州市临川区公安局	江西省抚州市临川区
抚州市宜黄县公安局	江西省抚州市宜黄县
抚州市黎川县公安局	江西省抚州市黎川县
南昌市东湖区公安局	江西省南昌市东湖区
南昌市新建区公安局	江西省南昌市新建区
南昌市青山湖区公安局	江西省南昌市青山湖区
南昌市安义县公安局	江西省南昌市安义县
南昌市西湖区公安局	江西省南昌市西湖区
南昌市湾里区公安局	江西省南昌市湾里区
南昌市南昌县公安局	江西省南昌市南昌县
南昌市进贤县公安局	江西省南昌市进贤县
南昌市青云谱区公安局	江西省南昌市青云谱区
吉安市泰和县公安局	江西省吉安市泰和县
吉安市安福县公安局	江西省吉安市安福县
吉安市吉水县公安局	江西省吉安市吉水县
吉安市永新县公安局	江西省吉安市永新县
吉安市峡江县公安局	江西省吉安市峡江县
吉安市吉州区公安局	江西省吉安市吉州区
吉安市永丰县公安局	江西省吉安市永丰县
吉安市遂川县公安局	江西省吉安市遂川县
吉安市青原区公安局	江西省吉安市青原区
吉安市万安县公安局	江西省吉安市万安县
吉安市吉安县公安局	江西省吉安市吉安县
吉安市新干县公安局	江西省吉安市新干县
吉安市井冈山市公安局	江西省吉安市井冈山市
鹰潭市月湖区公安局	江西省鹰潭市月湖区
鹰潭市贵溪市公安局	江西省鹰潭市贵溪市
鹰潭市余江区公安局	江西省鹰潭市余江区
萍乡市湘东区公安局	江西省萍乡市湘东区
萍乡市芦溪县公安局	江西省萍乡市芦溪县
萍乡市上栗县公安局	江西省萍乡市上栗县
萍乡市安源区公安局	江西省萍乡市安源区
萍乡市莲花县公安局	江西省萍乡市莲花县
新余市渝水区公安局	江西省新余市渝水区
新余市分宜县公安局	江西省新余市分宜县
九江市修水县公安局	江西省九江市修水县
九江市武宁县公安局	江西省九江市武宁县
九江市彭泽县公安局	江西省九江市彭泽县
九江市瑞昌市公安局	江西省九江市瑞昌市
九江市湖口县公安局	江西省九江市湖口县
九江市庐山市公安局	江西省九江市庐山市
九江市柴桑区公安局	江西省九江市柴桑区
九江市德安县公安局	江西省九江市德安县
九江市永修县公安局	江西省九江市永修县
九江市都昌县公安局	江西省九江市都昌县
九江市濂溪区公安局	江西省九江市濂溪区
九江市浔阳区公安局	江西省九江市浔阳区
九江市共青城市公安局	江西省九江市共青城市
上饶市铅山县公安局	江西省上饶市铅山县
上饶市余干县公安局	江西省上饶市余干县
上饶市德兴市公安局	江西省上饶市德兴市
上饶市上饶县公安局	江西省上饶市上饶县
上饶市婺源县公安局	江西省上饶市婺源县
上饶市万年县公安局	江西省上饶市万年县
上饶市横峰县公安局	江西省上饶市横峰县
上饶市玉山县公安局	江西省上饶市玉山县
上饶市鄱阳县公安局	江西省上饶市鄱阳县
上饶市信州区公安局	江西省上饶市信州区
上饶市弋阳县公安局	江西省上饶市弋阳县
上饶市广丰区公安局	江西省上饶市广丰区
赣州市崇义县公安局	江西省赣州市崇义县
赣州市石城县公安局	江西省赣州市石城县
赣州市宁都县公安局	江西省赣州市宁都县
赣州市大余县公安局	江西省赣州市大余县
赣州市南康区公安局	江西省赣州市南康区
赣州市定南县公安局	江西省赣州市定南县
赣州市赣县区公安局	江西省赣州市赣县区
赣州市于都县公安局	江西省赣州市于都县
赣州市章贡区公安局	江西省赣州市章贡区
赣州市寻乌县公安局	江西省赣州市寻乌县
赣州市瑞金市公安局	江西省赣州市瑞金市
赣州市上犹县公安局	江西省赣州市上犹县
赣州市信丰县公安局	江西省赣州市信丰县
赣州市会昌县公安局	江西省赣州市会昌县
赣州市安远县公安局	江西省赣州市安远县
赣州市兴国县公安局	江西省赣州市兴国县
赣州市全南县公安局	江西省赣州市全南县
赣州市龙南县公安局	江西省赣州市龙南县
宜春市高安市公安局	江西省宜春市高安市
宜春市上高县公安局	江西省宜春市上高县
宜春市丰城市公安局	江西省宜春市丰城市
宜春市袁州区公安局	江西省宜春市袁州区
宜春市万载县公安局	江西省宜春市万载县
宜春市铜鼓县公安局	江西省宜春市铜鼓县
宜春市宜丰县公安局	江西省宜春市宜丰县
宜春市靖安县公安局	江西省宜春市靖安县
宜春市奉新县公安局	江西省宜春市奉新县
宜春市樟树市公安局	江西省宜春市樟树市
景德镇市昌江区公安局	江西省景德镇市昌江区
景德镇市珠山区公安局	江西省景德镇市珠山区
景德镇市浮梁县公安局	江西省景德镇市浮梁县
景德镇市乐平市公安局	江西省景德镇市乐平市
榆林市子洲县公安局	陕西省榆林市子洲县
榆林市定边县公安局	陕西省榆林市定边县
榆林市横山区公安局	陕西省榆林市横山区
榆林市清涧县公安局	陕西省榆林市清涧县
榆林市神木市公安局	陕西省榆林市神木市
榆林市米脂县公安局	陕西省榆林市米脂县
榆林市绥德县公安局	陕西省榆林市绥德县
榆林市吴堡县公安局	陕西省榆林市吴堡县
榆林市榆阳区公安局	陕西省榆林市榆阳区
榆林市佳县公安局	陕西省榆林市佳县
榆林市府谷县公安局	陕西省榆林市府谷县
榆林市靖边县公安局	陕西省榆林市靖边县
咸阳市彬州市公安局	陕西省咸阳市彬州市
泉州市石狮市公安局	福建省泉州市石狮市
泉州市安溪县公安局	福建省泉州市安溪县
泉州市晋江市公安局	福建省泉州市晋江市
泉州市泉港区公安局	福建省泉州市泉港区
泉州市南安市公安局	福建省泉州市南安市
泉州市惠安县公安局	福建省泉州市惠安县
泉州市丰泽区公安局	福建省泉州市丰泽区
泉州市德化县公安局	福建省泉州市德化县
泉州市洛江区公安局	福建省泉州市洛江区
泉州市鲤城区公安局	福建省泉州市鲤城区
泉州市永春县公安局	福建省泉州市永春县
三明市沙县公安局	福建省三明市沙县
莆田市涵江区公安局	福建省莆田市涵江区
莆田市荔城区公安局	福建省莆田市荔城区
莆田市城厢区公安局	福建省莆田市城厢区
莆田市秀屿区公安局	福建省莆田市秀屿区
莆田市仙游县公安局	福建省莆田市仙游县
福州市平潭县公安局	福建省福州市平潭县
福州市连江县公安局	福建省福州市连江县
福州市鼓楼区公安局	福建省福州市鼓楼区
福州市闽侯县公安局	福建省福州市闽侯县
福州市台江区公安局	福建省福州市台江区
福州市罗源县公安局	福建省福州市罗源县
福州市马尾区公安局	福建省福州市马尾区
福州市永泰县公安局	福建省福州市永泰县
福州市仓山区公安局	福建省福州市仓山区
福州市闽清县公安局	福建省福州市闽清县
福州市长乐区公安局	福建省福州市长乐区
福州市福清市公安局	福建省福州市福清市
福州市晋安区公安局	福建省福州市晋安区
南平市建瓯市公安局	福建省南平市建瓯市
南平市顺昌县公安局	福建省南平市顺昌县
南平市延平区公安局	福建省南平市延平区
南平市武夷山市公安局	福建省南平市武夷山市
南平市光泽县公安局	福建省南平市光泽县
南平市建阳区公安局	福建省南平市建阳区
南平市政和县公安局	福建省南平市政和县
南平市松溪县公安局	福建省南平市松溪县
南平市浦城县公安局	福建省南平市浦城县
南平市邵武市公安局	福建省南平市邵武市
龙岩市连城县公安局	福建省龙岩市连城县
龙岩市上杭县公安局	福建省龙岩市上杭县
龙岩市永定区公安局	福建省龙岩市永定区
龙岩市长汀县公安局	福建省龙岩市长汀县
龙岩市漳平市公安局	福建省龙岩市漳平市
龙岩市武平县公安局	福建省龙岩市武平县
龙岩市新罗区公安局	福建省龙岩市新罗区
宁德市古田县公安局	福建省宁德市古田县
宁德市福鼎市公安局	福建省宁德市福鼎市
宁德市蕉城区公安局	福建省宁德市蕉城区
宁德市周宁县公安局	福建省宁德市周宁县
宁德市霞浦县公安局	福建省宁德市霞浦县
宁德市福安市公安局	福建省宁德市福安市
宁德市柘荣县公安局	福建省宁德市柘荣县
宁德市寿宁县公安局	福建省宁德市寿宁县
宁德市屏南县公安局	福建省宁德市屏南县
厦门市集美区公安局	福建省厦门市集美区
厦门市翔安区公安局	福建省厦门市翔安区
厦门市湖里区公安局	福建省厦门市湖里区
厦门市同安区公安局	福建省厦门市同安区
厦门市海沧区公安局	福建省厦门市海沧区
厦门市思明区公安局	福建省厦门市思明区
漳州市龙海市公安局	福建省漳州市龙海市
漳州市龙文区公安局	福建省漳州市龙文区
漳州市诏安县公安局	福建省漳州市诏安县
漳州市长泰县公安局	福建省漳州市长泰县
漳州市平和县公安局	福建省漳州市平和县
漳州市东山县公安局	福建省漳州市东山县
漳州市南靖县公安局	福建省漳州市南靖县
漳州市漳浦县公安局	福建省漳州市漳浦县
漳州市云霄县公安局	福建省漳州市云霄县
漳州市芗城区公安局	福建省漳州市芗城区
漳州市华安县公安局	福建省漳州市华安县
宜昌市远安县公安局	湖北省宜昌市远安县
宜昌市枝江市公安局	湖北省宜昌市枝江市
宜昌市猇亭区公安局	湖北省宜昌市猇亭区
宜昌市伍家岗区公安局	湖北省宜昌市伍家岗区
宜昌市夷陵区公安局	湖北省宜昌市夷陵区
宜昌市点军区公安局	湖北省宜昌市点军区
宜昌市西陵区公安局	湖北省宜昌市西陵区
宜昌市秭归县公安局	湖北省宜昌市秭归县
宜昌市当阳市公安局	湖北省宜昌市当阳市
宜昌市五峰土家族自治县公安局	湖北省宜昌市五峰土家族自治县
宜昌市长阳土家族自治县公安局	湖北省宜昌市长阳土家族自治县
宜昌市兴山县公安局	湖北省宜昌市兴山县
宜昌市宜都市公安局	湖北省宜昌市宜都市
随州市曾都区公安局	湖北省随州市曾都区
随州市广水市公安局	湖北省随州市广水市
随州市随县公安局	湖北省随州市随县
咸宁市赤壁市公安局	湖北省咸宁市赤壁市
咸宁市崇阳县公安局	湖北省咸宁市崇阳县
咸宁市通山县公安局	湖北省咸宁市通山县
咸宁市嘉鱼县公安局	湖北省咸宁市嘉鱼县
咸宁市咸安区公安局	湖北省咸宁市咸安区
咸宁市通城县公安局	湖北省咸宁市通城县
襄阳市保康县公安局	湖北省襄阳市保康县
襄阳市樊城区公安局	湖北省襄阳市樊城区
襄阳市老河口市公安局	湖北省襄阳市老河口市
襄阳市襄州区公安局	湖北省襄阳市襄州区
襄阳市南漳县公安局	湖北省襄阳市南漳县
襄阳市襄城区公安局	湖北省襄阳市襄城区
襄阳市枣阳市公安局	湖北省襄阳市枣阳市
襄阳市宜城市公安局	湖北省襄阳市宜城市
襄阳市谷城县公安局	湖北省襄阳市谷城县
恩施土家族苗族自治州来凤县公安局	湖北省恩施土家族苗族自治州来凤县
恩施土家族苗族自治州建始县公安局	湖北省恩施土家族苗族自治州建始县
恩施土家族苗族自治州咸丰县公安局	湖北省恩施土家族苗族自治州咸丰县
恩施土家族苗族自治州巴东县公安局	湖北省恩施土家族苗族自治州巴东县
恩施土家族苗族自治州利川市公安局	湖北省恩施土家族苗族自治州利川市
恩施土家族苗族自治州恩施市公安局	湖北省恩施土家族苗族自治州恩施市
恩施土家族苗族自治州鹤峰县公安局	湖北省恩施土家族苗族自治州鹤峰县
恩施土家族苗族自治州宣恩县公安局	湖北省恩施土家族苗族自治州宣恩县
黄冈市团风县公安局	湖北省黄冈市团风县
黄冈市龙感湖管理区公安局	湖北省黄冈市龙感湖管理区
黄冈市武穴市公安局	湖北省黄冈市武穴市
黄冈市黄州区公安局	湖北省黄冈市黄州区
黄冈市黄梅县公安局	湖北省黄冈市黄梅县
黄冈市英山县公安局	湖北省黄冈市英山县
黄冈市浠水县公安局	湖北省黄冈市浠水县
黄冈市罗田县公安局	湖北省黄冈市罗田县
黄冈市麻城市公安局	湖北省黄冈市麻城市
黄冈市蕲春县公安局	湖北省黄冈市蕲春县
黄冈市红安县公安局	湖北省黄冈市红安县
荆州市沙市区公安局	湖北省荆州市沙市区
荆州市荆州区公安局	湖北省荆州市荆州区
荆州市石首市公安局	湖北省荆州市石首市
荆州市松滋市公安局	湖北省荆州市松滋市
荆州市监利县公安局	湖北省荆州市监利县
荆州市公安县公安局	湖北省荆州市公安县
荆州市江陵县公安局	湖北省荆州市江陵县
荆州市洪湖市公安局	湖北省荆州市洪湖市
荆州市荆州经济技术开发区公安局	湖北省荆州市荆州经济技术开发区
十堰市张湾区公安局	湖北省十堰市张湾区
十堰市郧阳区公安局	湖北省十堰市郧阳区
十堰市房县公安局	湖北省十堰市房县
十堰市茅箭区公安局	湖北省十堰市茅箭区
十堰市竹溪县公安局	湖北省十堰市竹溪县
十堰市郧西县公安局	湖北省十堰市郧西县
十堰市丹江口市公安局	湖北省十堰市丹江口市
十堰市竹山县公安局	湖北省十堰市竹山县
孝感市大悟县公安局	湖北省孝感市大悟县
孝感市云梦县公安局	湖北省孝感市云梦县
孝感市汉川市公安局	湖北省孝感市汉川市
孝感市安陆市公安局	湖北省孝感市安陆市
孝感市孝南区公安局	湖北省孝感市孝南区
孝感市应城市公安局	湖北省孝感市应城市
孝感市孝昌县公安局	湖北省孝感市孝昌县
鄂州市鄂城区公安局	湖北省鄂州市鄂城区
鄂州市梁子湖区公安局	湖北省鄂州市梁子湖区
鄂州市华容区公安局	湖北省鄂州市华容区
荆门市东宝区公安局	湖北省荆门市东宝区
荆门市钟祥市公安局	湖北省荆门市钟祥市
荆门市沙洋县公安局	湖北省荆门市沙洋县
荆门市京山市公安局	湖北省荆门市京山市
荆门市掇刀区公安局	湖北省荆门市掇刀区
武汉市黄陂区公安局	湖北省武汉市黄陂区
武汉市汉阳区公安局	湖北省武汉市汉阳区
武汉市蔡甸区公安局	湖北省武汉市蔡甸区
武汉市青山区公安局	湖北省武汉市青山区
武汉市江夏区公安局	湖北省武汉市江夏区
武汉市汉南区公安局	湖北省武汉市汉南区
武汉市洪山区公安局	湖北省武汉市洪山区
武汉市东西湖区公安局	湖北省武汉市东西湖区
武汉市武昌区公安局	湖北省武汉市武昌区
武汉市新洲区公安局	湖北省武汉市新洲区
武汉市硚口区公安局	湖北省武汉市硚口区
武汉市江汉区公安局	湖北省武汉市江汉区
武汉市江岸区公安局	湖北省武汉市江岸区
省直辖县级行政区划潜江市公安局	湖北省省直辖县级行政区划潜江市
省直辖县级行政区划仙桃市公安局	湖北省省直辖县级行政区划仙桃市
省直辖县级行政区划天门市公安局	湖北省省直辖县级行政区划天门市
省直辖县级行政区划神农架林区公安局	湖北省省直辖县级行政区划神农架林区
黄石市黄石港区公安局	湖北省黄石市黄石港区
黄石市西塞山区公安局	湖北省黄石市西塞山区
黄石市下陆区公安局	湖北省黄石市下陆区
黄石市阳新县公安局	湖北省黄石市阳新县
黄石市铁山区公安局	湖北省黄石市铁山区
黄石市大冶市公安局	湖北省黄石市大冶市
雅安市宝兴县公安局	四川省雅安市宝兴县
雅安市天全县公安局	四川省雅安市天全县
雅安市芦山县公安局	四川省雅安市芦山县
雅安市汉源县公安局	四川省雅安市汉源县
雅安市雨城区公安局	四川省雅安市雨城区
雅安市名山区公安局	四川省雅安市名山区
雅安市荥经县公安局	四川省雅安市荥经县
雅安市石棉县公安局	四川省雅安市石棉县
达州市通川区公安局	四川省达州市通川区
达州市宣汉县公安局	四川省达州市宣汉县
达州市渠县公安局	四川省达州市渠县
达州市开江县公安局	四川省达州市开江县
达州市达川区公安局	四川省达州市达川区
达州市达州经济开发区公安局	四川省达州市达州经济开发区
达州市万源市公安局	四川省达州市万源市
达州市大竹县公安局	四川省达州市大竹县
成都市成华区公安局	四川省成都市成华区
成都市金牛区公安局	四川省成都市金牛区
成都市双流区公安局	四川省成都市双流区
成都市彭州市公安局	四川省成都市彭州市
成都市崇州市公安局	四川省成都市崇州市
成都市龙泉驿区公安局	四川省成都市龙泉驿区
成都市简阳市公安局	四川省成都市简阳市
成都市新都区公安局	四川省成都市新都区
成都市锦江区公安局	四川省成都市锦江区
成都市郫都区公安局	四川省成都市郫都区
成都市武侯区公安局	四川省成都市武侯区
成都市金堂县公安局	四川省成都市金堂县
成都市都江堰市公安局	四川省成都市都江堰市
成都市温江区公安局	四川省成都市温江区
成都市青白江区公安局	四川省成都市青白江区
成都市邛崃市公安局	四川省成都市邛崃市
成都市青羊区公安局	四川省成都市青羊区
成都市大邑县公安局	四川省成都市大邑县
成都市新津县公安局	四川省成都市新津县
成都市蒲江县公安局	四川省成都市蒲江县
宜宾市兴文县公安局	四川省宜宾市兴文县
宜宾市长宁县公安局	四川省宜宾市长宁县
宜宾市高县公安局	四川省宜宾市高县
宜宾市筠连县公安局	四川省宜宾市筠连县
宜宾市屏山县公安局	四川省宜宾市屏山县
宜宾市珙县公安局	四川省宜宾市珙县
宜宾市叙州区公安局	四川省宜宾市叙州区
宜宾市翠屏区公安局	四川省宜宾市翠屏区
宜宾市南溪区公安局	四川省宜宾市南溪区
宜宾市江安县公安局	四川省宜宾市江安县
广安市邻水县公安局	四川省广安市邻水县
广安市华蓥市公安局	四川省广安市华蓥市
广安市武胜县公安局	四川省广安市武胜县
广安市广安区公安局	四川省广安市广安区
广安市前锋区公安局	四川省广安市前锋区
广安市岳池县公安局	四川省广安市岳池县
德阳市中江县公安局	四川省德阳市中江县
德阳市绵竹市公安局	四川省德阳市绵竹市
德阳市广汉市公安局	四川省德阳市广汉市
德阳市旌阳区公安局	四川省德阳市旌阳区
德阳市什邡市公安局	四川省德阳市什邡市
德阳市罗江区公安局	四川省德阳市罗江区
内江市资中县公安局	四川省内江市资中县
内江市东兴区公安局	四川省内江市东兴区
内江市威远县公安局	四川省内江市威远县
内江市内江经济开发区公安局	四川省内江市内江经济开发区
内江市市中区公安局	四川省内江市市中区
内江市隆昌市公安局	四川省内江市隆昌市
广元市利州区公安局	四川省广元市利州区
广元市青川县公安局	四川省广元市青川县
广元市苍溪县公安局	四川省广元市苍溪县
广元市旺苍县公安局	四川省广元市旺苍县
广元市昭化区公安局	四川省广元市昭化区
庆阳市环县公安局	甘肃省庆阳市环县
庆阳市华池县公安局	甘肃省庆阳市华池县
庆阳市合水县公安局	甘肃省庆阳市合水县
庆阳市正宁县公安局	甘肃省庆阳市正宁县
庆阳市庆城县公安局	甘肃省庆阳市庆城县
庆阳市镇原县公安局	甘肃省庆阳市镇原县
庆阳市西峰区公安局	甘肃省庆阳市西峰区
庆阳市宁县公安局	甘肃省庆阳市宁县
平凉市崇信县公安局	甘肃省平凉市崇信县
平凉市华亭市公安局	甘肃省平凉市华亭市
平凉市庄浪县公安局	甘肃省平凉市庄浪县
平凉市静宁县公安局	甘肃省平凉市静宁县
平凉市崆峒区公安局	甘肃省平凉市崆峒区
平凉市灵台县公安局	甘肃省平凉市灵台县
平凉市泾川县公安局	甘肃省平凉市泾川县
酒泉市瓜州县公安局	甘肃省酒泉市瓜州县
酒泉市阿克塞哈萨克族自治县公安局	甘肃省酒泉市阿克塞哈萨克族自治县
酒泉市敦煌市公安局	甘肃省酒泉市敦煌市
酒泉市金塔县公安局	甘肃省酒泉市金塔县
酒泉市肃州区公安局	甘肃省酒泉市肃州区
酒泉市玉门市公安局	甘肃省酒泉市玉门市
酒泉市肃北蒙古族自治县公安局	甘肃省酒泉市肃北蒙古族自治县
甘南藏族自治州玛曲县公安局	甘肃省甘南藏族自治州玛曲县
甘南藏族自治州临潭县公安局	甘肃省甘南藏族自治州临潭县
甘南藏族自治州夏河县公安局	甘肃省甘南藏族自治州夏河县
甘南藏族自治州卓尼县公安局	甘肃省甘南藏族自治州卓尼县
甘南藏族自治州迭部县公安局	甘肃省甘南藏族自治州迭部县
甘南藏族自治州合作市公安局	甘肃省甘南藏族自治州合作市
甘南藏族自治州舟曲县公安局	甘肃省甘南藏族自治州舟曲县
甘南藏族自治州碌曲县公安局	甘肃省甘南藏族自治州碌曲县
金昌市金川区公安局	甘肃省金昌市金川区
金昌市永昌县公安局	甘肃省金昌市永昌县
武威市天祝藏族自治县公安局	甘肃省武威市天祝藏族自治县
武威市民勤县公安局	甘肃省武威市民勤县
武威市凉州区公安局	甘肃省武威市凉州区
武威市古浪县公安局	甘肃省武威市古浪县
天水市甘谷县公安局	甘肃省天水市甘谷县
天水市清水县公安局	甘肃省天水市清水县
天水市秦安县公安局	甘肃省天水市秦安县
天水市麦积区公安局	甘肃省天水市麦积区
天水市秦州区公安局	甘肃省天水市秦州区
天水市张家川回族自治县公安局	甘肃省天水市张家川回族自治县
天水市武山县公安局	甘肃省天水市武山县
陇南市成县公安局	甘肃省陇南市成县
陇南市宕昌县公安局	甘肃省陇南市宕昌县
陇南市西和县公安局	甘肃省陇南市西和县
陇南市礼县公安局	甘肃省陇南市礼县
陇南市两当县公安局	甘肃省陇南市两当县
陇南市武都区公安局	甘肃省陇南市武都区
陇南市徽县公安局	甘肃省陇南市徽县
陇南市康县公安局	甘肃省陇南市康县
陇南市文县公安局	甘肃省陇南市文县
定西市临洮县公安局	甘肃省定西市临洮县
定西市岷县公安局	甘肃省定西市岷县
马鞍山市当涂县公安局	安徽省马鞍山市当涂县
马鞍山市雨山区公安局	安徽省马鞍山市雨山区
马鞍山市博望区公安局	安徽省马鞍山市博望区
马鞍山市含山县公安局	安徽省马鞍山市含山县
马鞍山市花山区公安局	安徽省马鞍山市花山区
马鞍山市和县公安局	安徽省马鞍山市和县
蚌埠市蚌山区公安局	安徽省蚌埠市蚌山区
蚌埠市龙子湖区公安局	安徽省蚌埠市龙子湖区
蚌埠市蚌埠市高新技术开发区公安局	安徽省蚌埠市蚌埠市高新技术开发区
蚌埠市怀远县公安局	安徽省蚌埠市怀远县
蚌埠市五河县公安局	安徽省蚌埠市五河县
蚌埠市固镇县公安局	安徽省蚌埠市固镇县
蚌埠市蚌埠市经济开发区公安局	安徽省蚌埠市蚌埠市经济开发区
蚌埠市淮上区公安局	安徽省蚌埠市淮上区
蚌埠市禹会区公安局	安徽省蚌埠市禹会区
六安市金安区公安局	安徽省六安市金安区
六安市叶集区公安局	安徽省六安市叶集区
六安市霍邱县公安局	安徽省六安市霍邱县
六安市舒城县公安局	安徽省六安市舒城县
六安市霍山县公安局	安徽省六安市霍山县
六安市金寨县公安局	安徽省六安市金寨县
六安市裕安区公安局	安徽省六安市裕安区
阜阳市阜阳合肥现代产业园区公安局	安徽省阜阳市阜阳合肥现代产业园区
阜阳市颍上县公安局	安徽省阜阳市颍上县
阜阳市颍泉区公安局	安徽省阜阳市颍泉区
阜阳市太和县公安局	安徽省阜阳市太和县
阜阳市阜阳经济技术开发区公安局	安徽省阜阳市阜阳经济技术开发区
阜阳市颍东区公安局	安徽省阜阳市颍东区
阜阳市界首市公安局	安徽省阜阳市界首市
阜阳市阜南县公安局	安徽省阜阳市阜南县
阜阳市颍州区公安局	安徽省阜阳市颍州区
阜阳市临泉县公安局	安徽省阜阳市临泉县
黄山市歙县公安局	安徽省黄山市歙县
黄山市祁门县公安局	安徽省黄山市祁门县
黄山市黄山区公安局	安徽省黄山市黄山区
黄山市休宁县公安局	安徽省黄山市休宁县
黄山市屯溪区公安局	安徽省黄山市屯溪区
黄山市黟县公安局	安徽省黄山市黟县
黄山市徽州区公安局	安徽省黄山市徽州区
宿州市埇桥区公安局	安徽省宿州市埇桥区
宿州市宿州马鞍山现代产业园区公安局	安徽省宿州市宿州马鞍山现代产业园区
宿州市宿州经济技术开发区公安局	安徽省宿州市宿州经济技术开发区
宿州市泗县公安局	安徽省宿州市泗县
宿州市萧县公安局	安徽省宿州市萧县
宿州市灵璧县公安局	安徽省宿州市灵璧县
宿州市砀山县公安局	安徽省宿州市砀山县
淮北市杜集区公安局	安徽省淮北市杜集区
淮北市烈山区公安局	安徽省淮北市烈山区
淮北市相山区公安局	安徽省淮北市相山区
淮北市濉溪县公安局	安徽省淮北市濉溪县
铜陵市铜官区公安局	安徽省铜陵市铜官区
铜陵市郊区公安局	安徽省铜陵市郊区
铜陵市枞阳县公安局	安徽省铜陵市枞阳县
铜陵市义安区公安局	安徽省铜陵市义安区
淮南市大通区公安局	安徽省淮南市大通区
淮南市八公山区公安局	安徽省淮南市八公山区
淮南市凤台县公安局	安徽省淮南市凤台县
淮南市谢家集区公安局	安徽省淮南市谢家集区
淮南市潘集区公安局	安徽省淮南市潘集区
淮南市寿县公安局	安徽省淮南市寿县
淮南市田家庵区公安局	安徽省淮南市田家庵区
亳州市谯城区公安局	安徽省亳州市谯城区
亳州市利辛县公安局	安徽省亳州市利辛县
亳州市涡阳县公安局	安徽省亳州市涡阳县
亳州市蒙城县公安局	安徽省亳州市蒙城县
芜湖市三山区公安局	安徽省芜湖市三山区
芜湖市芜湖县公安局	安徽省芜湖市芜湖县
芜湖市繁昌县公安局	安徽省芜湖市繁昌县
芜湖市无为县公安局	安徽省芜湖市无为县
芜湖市南陵县公安局	安徽省芜湖市南陵县
芜湖市安徽芜湖长江大桥经济开发区公安局	安徽省芜湖市安徽芜湖长江大桥经济开发区
芜湖市芜湖经济技术开发区公安局	安徽省芜湖市芜湖经济技术开发区
芜湖市弋江区公安局	安徽省芜湖市弋江区
芜湖市镜湖区公安局	安徽省芜湖市镜湖区
芜湖市鸠江区公安局	安徽省芜湖市鸠江区
滁州市南谯区公安局	安徽省滁州市南谯区
滁州市琅琊区公安局	安徽省滁州市琅琊区
滁州市苏滁现代产业园公安局	安徽省滁州市苏滁现代产业园
滁州市定远县公安局	安徽省滁州市定远县
滁州市滁州经济技术开发区公安局	安徽省滁州市滁州经济技术开发区
滁州市全椒县公安局	安徽省滁州市全椒县
滁州市凤阳县公安局	安徽省滁州市凤阳县
滁州市来安县公安局	安徽省滁州市来安县
滁州市天长市公安局	安徽省滁州市天长市
滁州市明光市公安局	安徽省滁州市明光市
池州市贵池区公安局	安徽省池州市贵池区
池州市石台县公安局	安徽省池州市石台县
池州市青阳县公安局	安徽省池州市青阳县
池州市东至县公安局	安徽省池州市东至县
宣城市旌德县公安局	安徽省宣城市旌德县
宣城市宣城市经济开发区公安局	安徽省宣城市宣城市经济开发区
宣城市广德县公安局	安徽省宣城市广德县
宣城市泾县公安局	安徽省宣城市泾县
宣城市宁国市公安局	安徽省宣城市宁国市
宣城市郎溪县公安局	安徽省宣城市郎溪县
宣城市绩溪县公安局	安徽省宣城市绩溪县
宣城市宣州区公安局	安徽省宣城市宣州区
合肥市长丰县公安局	安徽省合肥市长丰县
合肥市合肥经济技术开发区公安局	安徽省合肥市合肥经济技术开发区
合肥市肥东县公安局	安徽省合肥市肥东县
合肥市包河区公安局	安徽省合肥市包河区
合肥市巢湖市公安局	安徽省合肥市巢湖市
合肥市瑶海区公安局	安徽省合肥市瑶海区
合肥市合肥高新技术产业开发区公安局	安徽省合肥市合肥高新技术产业开发区
合肥市蜀山区公安局	安徽省合肥市蜀山区
合肥市庐江县公安局	安徽省合肥市庐江县
合肥市庐阳区公安局	安徽省合肥市庐阳区
合肥市合肥新站高新技术产业开发区公安局	安徽省合肥市合肥新站高新技术产业开发区
合肥市肥西县公安局	安徽省合肥市肥西县
安庆市岳西县公安局	安徽省安庆市岳西县
安庆市太湖县公安局	安徽省安庆市太湖县
安庆市潜山市公安局	安徽省安庆市潜山市
安庆市桐城市公安局	安徽省安庆市桐城市
安庆市宜秀区公安局	安徽省安庆市宜秀区
安庆市安徽安庆经济开发区公安局	安徽省安庆市安徽安庆经济开发区
安庆市大观区公安局	安徽省安庆市大观区
安庆市迎江区公安局	安徽省安庆市迎江区
安庆市望江县公安局	安徽省安庆市望江县
安庆市怀宁县公安局	安徽省安庆市怀宁县
安庆市宿松县公安局	安徽省安庆市宿松县
市辖区静安区公安局	上海市市辖区静安区
市辖区虹口区公安局	上海市市辖区虹口区
市辖区浦东新区公安局	上海市市辖区浦东新区
市辖区金山区公安局	上海市市辖区金山区
市辖区宝山区公安局	上海市市辖区宝山区
市辖区奉贤区公安局	上海市市辖区奉贤区
市辖区黄浦区公安局	上海市市辖区黄浦区
市辖区青浦区公安局	上海市市辖区青浦区
市辖区松江区公安局	上海市市辖区松江区
市辖区崇明区公安局	上海市市辖区崇明区
市辖区杨浦区公安局	上海市市辖区杨浦区
市辖区长宁区公安局	上海市市辖区长宁区
市辖区徐汇区公安局	上海市市辖区徐汇区
市辖区闵行区公安局	上海市市辖区闵行区
市辖区嘉定区公安局	上海市市辖区嘉定区
市辖区普陀区公安局	上海市市辖区普陀区
大庆市林甸县公安局	黑龙江省大庆市林甸县
大庆市大同区公安局	黑龙江省大庆市大同区
大庆市肇源县公安局	黑龙江省大庆市肇源县
大庆市大庆高新技术产业开发区公安局	黑龙江省大庆市大庆高新技术产业开发区
大庆市萨尔图区公安局	黑龙江省大庆市萨尔图区
大庆市红岗区公安局	黑龙江省大庆市红岗区
大庆市龙凤区公安局	黑龙江省大庆市龙凤区
大庆市让胡路区公安局	黑龙江省大庆市让胡路区
大庆市肇州县公安局	黑龙江省大庆市肇州县
大庆市杜尔伯特蒙古族自治县公安局	黑龙江省大庆市杜尔伯特蒙古族自治县
双鸭山市集贤县公安局	黑龙江省双鸭山市集贤县
双鸭山市友谊县公安局	黑龙江省双鸭山市友谊县
双鸭山市饶河县公安局	黑龙江省双鸭山市饶河县
双鸭山市岭东区公安局	黑龙江省双鸭山市岭东区
双鸭山市宝山区公安局	黑龙江省双鸭山市宝山区
双鸭山市四方台区公安局	黑龙江省双鸭山市四方台区
双鸭山市尖山区公安局	黑龙江省双鸭山市尖山区
双鸭山市宝清县公安局	黑龙江省双鸭山市宝清县
佳木斯市桦川县公安局	黑龙江省佳木斯市桦川县
佳木斯市同江市公安局	黑龙江省佳木斯市同江市
佳木斯市抚远市公安局	黑龙江省佳木斯市抚远市
佳木斯市前进区公安局	黑龙江省佳木斯市前进区
佳木斯市东风区公安局	黑龙江省佳木斯市东风区
佳木斯市富锦市公安局	黑龙江省佳木斯市富锦市
佳木斯市向阳区公安局	黑龙江省佳木斯市向阳区
佳木斯市桦南县公安局	黑龙江省佳木斯市桦南县
佳木斯市郊区公安局	黑龙江省佳木斯市郊区
佳木斯市汤原县公安局	黑龙江省佳木斯市汤原县
七台河市新兴区公安局	黑龙江省七台河市新兴区
七台河市茄子河区公安局	黑龙江省七台河市茄子河区
七台河市桃山区公安局	黑龙江省七台河市桃山区
七台河市勃利县公安局	黑龙江省七台河市勃利县
鸡西市恒山区公安局	黑龙江省鸡西市恒山区
鸡西市城子河区公安局	黑龙江省鸡西市城子河区
鸡西市滴道区公安局	黑龙江省鸡西市滴道区
鸡西市麻山区公安局	黑龙江省鸡西市麻山区
鸡西市虎林市公安局	黑龙江省鸡西市虎林市
鸡西市鸡东县公安局	黑龙江省鸡西市鸡东县
鸡西市密山市公安局	黑龙江省鸡西市密山市
鸡西市鸡冠区公安局	黑龙江省鸡西市鸡冠区
鸡西市梨树区公安局	黑龙江省鸡西市梨树区
大兴安岭地区新林区公安局	黑龙江省大兴安岭地区新林区
大兴安岭地区塔河县公安局	黑龙江省大兴安岭地区塔河县
大兴安岭地区松岭区公安局	黑龙江省大兴安岭地区松岭区
大兴安岭地区呼中区公安局	黑龙江省大兴安岭地区呼中区
大兴安岭地区呼玛县公安局	黑龙江省大兴安岭地区呼玛县
大兴安岭地区加格达奇区公安局	黑龙江省大兴安岭地区加格达奇区
伊春市伊春区公安局	黑龙江省伊春市伊春区
伊春市嘉荫县公安局	黑龙江省伊春市嘉荫县
伊春市翠峦区公安局	黑龙江省伊春市翠峦区
伊春市乌伊岭区公安局	黑龙江省伊春市乌伊岭区
伊春市铁力市公安局	黑龙江省伊春市铁力市
伊春市西林区公安局	黑龙江省伊春市西林区
伊春市金山屯区公安局	黑龙江省伊春市金山屯区
伊春市美溪区公安局	黑龙江省伊春市美溪区
伊春市友好区公安局	黑龙江省伊春市友好区
伊春市乌马河区公安局	黑龙江省伊春市乌马河区
伊春市五营区公安局	黑龙江省伊春市五营区
伊春市新青区公安局	黑龙江省伊春市新青区
伊春市带岭区公安局	黑龙江省伊春市带岭区
伊春市上甘岭区公安局	黑龙江省伊春市上甘岭区
伊春市红星区公安局	黑龙江省伊春市红星区
伊春市汤旺河区公安局	黑龙江省伊春市汤旺河区
伊春市南岔区公安局	黑龙江省伊春市南岔区
齐齐哈尔市碾子山区公安局	黑龙江省齐齐哈尔市碾子山区
齐齐哈尔市富裕县公安局	黑龙江省齐齐哈尔市富裕县
齐齐哈尔市铁锋区公安局	黑龙江省齐齐哈尔市铁锋区
齐齐哈尔市龙江县公安局	黑龙江省齐齐哈尔市龙江县
齐齐哈尔市甘南县公安局	黑龙江省齐齐哈尔市甘南县
齐齐哈尔市克东县公安局	黑龙江省齐齐哈尔市克东县
齐齐哈尔市泰来县公安局	黑龙江省齐齐哈尔市泰来县
齐齐哈尔市龙沙区公安局	黑龙江省齐齐哈尔市龙沙区
齐齐哈尔市讷河市公安局	黑龙江省齐齐哈尔市讷河市
齐齐哈尔市建华区公安局	黑龙江省齐齐哈尔市建华区
齐齐哈尔市梅里斯达斡尔族区公安局	黑龙江省齐齐哈尔市梅里斯达斡尔族区
齐齐哈尔市昂昂溪区公安局	黑龙江省齐齐哈尔市昂昂溪区
齐齐哈尔市富拉尔基区公安局	黑龙江省齐齐哈尔市富拉尔基区
齐齐哈尔市克山县公安局	黑龙江省齐齐哈尔市克山县
齐齐哈尔市拜泉县公安局	黑龙江省齐齐哈尔市拜泉县
齐齐哈尔市依安县公安局	黑龙江省齐齐哈尔市依安县
哈尔滨市尚志市公安局	黑龙江省哈尔滨市尚志市
哈尔滨市双城区公安局	黑龙江省哈尔滨市双城区
哈尔滨市延寿县公安局	黑龙江省哈尔滨市延寿县
哈尔滨市香坊区公安局	黑龙江省哈尔滨市香坊区
哈尔滨市平房区公安局	黑龙江省哈尔滨市平房区
哈尔滨市方正县公安局	黑龙江省哈尔滨市方正县
哈尔滨市阿城区公安局	黑龙江省哈尔滨市阿城区
哈尔滨市呼兰区公安局	黑龙江省哈尔滨市呼兰区
哈尔滨市南岗区公安局	黑龙江省哈尔滨市南岗区
哈尔滨市宾县公安局	黑龙江省哈尔滨市宾县
哈尔滨市巴彦县公安局	黑龙江省哈尔滨市巴彦县
哈尔滨市道外区公安局	黑龙江省哈尔滨市道外区
哈尔滨市木兰县公安局	黑龙江省哈尔滨市木兰县
哈尔滨市通河县公安局	黑龙江省哈尔滨市通河县
哈尔滨市道里区公安局	黑龙江省哈尔滨市道里区
哈尔滨市五常市公安局	黑龙江省哈尔滨市五常市
哈尔滨市松北区公安局	黑龙江省哈尔滨市松北区
哈尔滨市依兰县公安局	黑龙江省哈尔滨市依兰县
牡丹江市林口县公安局	黑龙江省牡丹江市林口县
牡丹江市绥芬河市公安局	黑龙江省牡丹江市绥芬河市
牡丹江市爱民区公安局	黑龙江省牡丹江市爱民区
牡丹江市穆棱市公安局	黑龙江省牡丹江市穆棱市
牡丹江市海林市公安局	黑龙江省牡丹江市海林市
牡丹江市牡丹江经济技术开发区公安局	黑龙江省牡丹江市牡丹江经济技术开发区
牡丹江市西安区公安局	黑龙江省牡丹江市西安区
牡丹江市东宁市公安局	黑龙江省牡丹江市东宁市
牡丹江市东安区公安局	黑龙江省牡丹江市东安区
牡丹江市宁安市公安局	黑龙江省牡丹江市宁安市
牡丹江市阳明区公安局	黑龙江省牡丹江市阳明区
绥化市绥棱县公安局	黑龙江省绥化市绥棱县
绥化市北林区公安局	黑龙江省绥化市北林区
绥化市兰西县公安局	黑龙江省绥化市兰西县
绥化市青冈县公安局	黑龙江省绥化市青冈县
绥化市庆安县公安局	黑龙江省绥化市庆安县
绥化市安达市公安局	黑龙江省绥化市安达市
绥化市海伦市公安局	黑龙江省绥化市海伦市
绥化市望奎县公安局	黑龙江省绥化市望奎县
绥化市明水县公安局	黑龙江省绥化市明水县
绥化市肇东市公安局	黑龙江省绥化市肇东市
黑河市逊克县公安局	黑龙江省黑河市逊克县
黑河市孙吴县公安局	黑龙江省黑河市孙吴县
黑河市北安市公安局	黑龙江省黑河市北安市
黑河市嫩江县公安局	黑龙江省黑河市嫩江县
黑河市爱辉区公安局	黑龙江省黑河市爱辉区
黑河市五大连池市公安局	黑龙江省黑河市五大连池市
鹤岗市兴山区公安局	黑龙江省鹤岗市兴山区
鹤岗市兴安区公安局	黑龙江省鹤岗市兴安区
鹤岗市南山区公安局	黑龙江省鹤岗市南山区
鹤岗市工农区公安局	黑龙江省鹤岗市工农区
鹤岗市绥滨县公安局	黑龙江省鹤岗市绥滨县
鹤岗市向阳区公安局	黑龙江省鹤岗市向阳区
鹤岗市东山区公安局	黑龙江省鹤岗市东山区
鹤岗市萝北县公安局	黑龙江省鹤岗市萝北县
吴忠市红寺堡区公安局	宁夏回族自治区吴忠市红寺堡区
石嘴山市大武口区公安局	宁夏回族自治区石嘴山市大武口区
石嘴山市平罗县公安局	宁夏回族自治区石嘴山市平罗县
石嘴山市惠农区公安局	宁夏回族自治区石嘴山市惠农区
中卫市沙坡头区公安局	宁夏回族自治区中卫市沙坡头区
中卫市中宁县公安局	宁夏回族自治区中卫市中宁县
中卫市海原县公安局	宁夏回族自治区中卫市海原县
银川市西夏区公安局	宁夏回族自治区银川市西夏区
银川市贺兰县公安局	宁夏回族自治区银川市贺兰县
银川市灵武市公安局	宁夏回族自治区银川市灵武市
银川市兴庆区公安局	宁夏回族自治区银川市兴庆区
银川市永宁县公安局	宁夏回族自治区银川市永宁县
银川市金凤区公安局	宁夏回族自治区银川市金凤区
昌吉回族自治州呼图壁县公安局	新疆维吾尔自治区昌吉回族自治州呼图壁县
昌吉回族自治州昌吉市公安局	新疆维吾尔自治区昌吉回族自治州昌吉市
昌吉回族自治州吉木萨尔县公安局	新疆维吾尔自治区昌吉回族自治州吉木萨尔县
昌吉回族自治州奇台县公安局	新疆维吾尔自治区昌吉回族自治州奇台县
昌吉回族自治州玛纳斯县公安局	新疆维吾尔自治区昌吉回族自治州玛纳斯县
昌吉回族自治州阜康市公安局	新疆维吾尔自治区昌吉回族自治州阜康市
昌吉回族自治州木垒哈萨克自治县公安局	新疆维吾尔自治区昌吉回族自治州木垒哈萨克自治县
博尔塔拉蒙古自治州精河县公安局	新疆维吾尔自治区博尔塔拉蒙古自治州精河县
博尔塔拉蒙古自治州博乐市公安局	新疆维吾尔自治区博尔塔拉蒙古自治州博乐市
博尔塔拉蒙古自治州温泉县公安局	新疆维吾尔自治区博尔塔拉蒙古自治州温泉县
博尔塔拉蒙古自治州阿拉山口市公安局	新疆维吾尔自治区博尔塔拉蒙古自治州阿拉山口市
克孜勒苏柯尔克孜自治州阿图什市公安局	新疆维吾尔自治区克孜勒苏柯尔克孜自治州阿图什市
克孜勒苏柯尔克孜自治州阿克陶县公安局	新疆维吾尔自治区克孜勒苏柯尔克孜自治州阿克陶县
克孜勒苏柯尔克孜自治州阿合奇县公安局	新疆维吾尔自治区克孜勒苏柯尔克孜自治州阿合奇县
克孜勒苏柯尔克孜自治州乌恰县公安局	新疆维吾尔自治区克孜勒苏柯尔克孜自治州乌恰县
阿勒泰地区福海县公安局	新疆维吾尔自治区阿勒泰地区福海县
阿勒泰地区哈巴河县公安局	新疆维吾尔自治区阿勒泰地区哈巴河县
阿勒泰地区青河县公安局	新疆维吾尔自治区阿勒泰地区青河县
阿勒泰地区富蕴县公安局	新疆维吾尔自治区阿勒泰地区富蕴县
阿勒泰地区布尔津县公安局	新疆维吾尔自治区阿勒泰地区布尔津县
阿勒泰地区阿勒泰市公安局	新疆维吾尔自治区阿勒泰地区阿勒泰市
阿勒泰地区吉木乃县公安局	新疆维吾尔自治区阿勒泰地区吉木乃县
吐鲁番市高昌区公安局	新疆维吾尔自治区吐鲁番市高昌区
吐鲁番市托克逊县公安局	新疆维吾尔自治区吐鲁番市托克逊县
吐鲁番市鄯善县公安局	新疆维吾尔自治区吐鲁番市鄯善县
乌鲁木齐市沙依巴克区公安局	新疆维吾尔自治区乌鲁木齐市沙依巴克区
乌鲁木齐市达坂城区公安局	新疆维吾尔自治区乌鲁木齐市达坂城区
乌鲁木齐市天山区公安局	新疆维吾尔自治区乌鲁木齐市天山区
乌鲁木齐市水磨沟区公安局	新疆维吾尔自治区乌鲁木齐市水磨沟区
乌鲁木齐市新市区公安局	新疆维吾尔自治区乌鲁木齐市新市区
乌鲁木齐市米东区公安局	新疆维吾尔自治区乌鲁木齐市米东区
乌鲁木齐市头屯河区公安局	新疆维吾尔自治区乌鲁木齐市头屯河区
乌鲁木齐市乌鲁木齐经济技术开发区公安局	新疆维吾尔自治区乌鲁木齐市乌鲁木齐经济技术开发区
乌鲁木齐市乌鲁木齐高新技术产业开发区公安局	新疆维吾尔自治区乌鲁木齐市乌鲁木齐高新技术产业开发区
乌鲁木齐市乌鲁木齐县公安局	新疆维吾尔自治区乌鲁木齐市乌鲁木齐县
阿克苏地区阿克苏市公安局	新疆维吾尔自治区阿克苏地区阿克苏市
阿克苏地区温宿县公安局	新疆维吾尔自治区阿克苏地区温宿县
阿克苏地区拜城县公安局	新疆维吾尔自治区阿克苏地区拜城县
阿克苏地区乌什县公安局	新疆维吾尔自治区阿克苏地区乌什县
阿克苏地区库车县公安局	新疆维吾尔自治区阿克苏地区库车县
阿克苏地区柯坪县公安局	新疆维吾尔自治区阿克苏地区柯坪县
阿克苏地区新和县公安局	新疆维吾尔自治区阿克苏地区新和县
阿克苏地区阿瓦提县公安局	新疆维吾尔自治区阿克苏地区阿瓦提县
阿克苏地区沙雅县公安局	新疆维吾尔自治区阿克苏地区沙雅县
哈密市伊吾县公安局	新疆维吾尔自治区哈密市伊吾县
哈密市伊州区公安局	新疆维吾尔自治区哈密市伊州区
哈密市巴里坤哈萨克自治县公安局	新疆维吾尔自治区哈密市巴里坤哈萨克自治县
塔城地区额敏县公安局	新疆维吾尔自治区塔城地区额敏县
塔城地区裕民县公安局	新疆维吾尔自治区塔城地区裕民县
塔城地区托里县公安局	新疆维吾尔自治区塔城地区托里县
塔城地区和布克赛尔蒙古自治县公安局	新疆维吾尔自治区塔城地区和布克赛尔蒙古自治县
塔城地区塔城市公安局	新疆维吾尔自治区塔城地区塔城市
塔城地区沙湾县公安局	新疆维吾尔自治区塔城地区沙湾县
衡水市饶阳县公安局	河北省衡水市饶阳县
衡水市深州市公安局	河北省衡水市深州市
衡水市枣强县公安局	河北省衡水市枣强县
衡水市武邑县公安局	河北省衡水市武邑县
衡水市衡水滨湖新区公安局	河北省衡水市衡水滨湖新区
衡水市冀州区公安局	河北省衡水市冀州区
衡水市桃城区公安局	河北省衡水市桃城区
衡水市故城县公安局	河北省衡水市故城县
衡水市安平县公安局	河北省衡水市安平县
衡水市武强县公安局	河北省衡水市武强县
衡水市景县公安局	河北省衡水市景县
衡水市阜城县公安局	河北省衡水市阜城县
衡水市河北衡水经济开发区公安局	河北省衡水市河北衡水经济开发区
邢台市任县公安局	河北省邢台市任县
邢台市南和县公安局	河北省邢台市南和县
邢台市隆尧县公安局	河北省邢台市隆尧县
邢台市新河县公安局	河北省邢台市新河县
邢台市平乡县公安局	河北省邢台市平乡县
邢台市沙河市公安局	河北省邢台市沙河市
邢台市宁晋县公安局	河北省邢台市宁晋县
邢台市桥东区公安局	河北省邢台市桥东区
邢台市邢台县公安局	河北省邢台市邢台县
邢台市巨鹿县公安局	河北省邢台市巨鹿县
邢台市内丘县公安局	河北省邢台市内丘县
邢台市临城县公安局	河北省邢台市临城县
邢台市柏乡县公安局	河北省邢台市柏乡县
邢台市威县公安局	河北省邢台市威县
邢台市清河县公安局	河北省邢台市清河县
邢台市临西县公安局	河北省邢台市临西县
邢台市桥西区公安局	河北省邢台市桥西区
邢台市河北邢台经济开发区公安局	河北省邢台市河北邢台经济开发区
邢台市广宗县公安局	河北省邢台市广宗县
邢台市南宫市公安局	河北省邢台市南宫市
唐山市迁西县公安局	河北省唐山市迁西县
唐山市丰南区公安局	河北省唐山市丰南区
唐山市河北唐山海港经济开发区公安局	河北省唐山市河北唐山海港经济开发区
唐山市路北区公安局	河北省唐山市路北区
唐山市路南区公安局	河北省唐山市路南区
唐山市乐亭县公安局	河北省唐山市乐亭县
唐山市唐山市汉沽管理区公安局	河北省唐山市唐山市汉沽管理区
唐山市滦州市公安局	河北省唐山市滦州市
唐山市丰润区公安局	河北省唐山市丰润区
唐山市唐山高新技术产业开发区公安局	河北省唐山市唐山高新技术产业开发区
唐山市曹妃甸区公安局	河北省唐山市曹妃甸区
唐山市开平区公安局	河北省唐山市开平区
唐山市遵化市公安局	河北省唐山市遵化市
唐山市古冶区公安局	河北省唐山市古冶区
唐山市迁安市公安局	河北省唐山市迁安市
唐山市玉田县公安局	河北省唐山市玉田县
唐山市滦南县公安局	河北省唐山市滦南县
唐山市唐山市芦台经济技术开发区公安局	河北省唐山市唐山市芦台经济技术开发区
秦皇岛市北戴河区公安局	河北省秦皇岛市北戴河区
秦皇岛市青龙满族自治县公安局	河北省秦皇岛市青龙满族自治县
秦皇岛市昌黎县公安局	河北省秦皇岛市昌黎县
秦皇岛市秦皇岛市经济技术开发区公安局	河北省秦皇岛市秦皇岛市经济技术开发区
秦皇岛市北戴河新区公安局	河北省秦皇岛市北戴河新区
秦皇岛市山海关区公安局	河北省秦皇岛市山海关区
秦皇岛市卢龙县公安局	河北省秦皇岛市卢龙县
秦皇岛市抚宁区公安局	河北省秦皇岛市抚宁区
秦皇岛市海港区公安局	河北省秦皇岛市海港区
保定市安新县公安局	河北省保定市安新县
保定市顺平县公安局	河北省保定市顺平县
保定市保定高新技术产业开发区公安局	河北省保定市保定高新技术产业开发区
保定市涞源县公安局	河北省保定市涞源县
保定市涞水县公安局	河北省保定市涞水县
保定市涿州市公安局	河北省保定市涿州市
保定市定兴县公安局	河北省保定市定兴县
保定市定州市公安局	河北省保定市定州市
保定市唐县公安局	河北省保定市唐县
保定市高碑店市公安局	河北省保定市高碑店市
保定市望都县公安局	河北省保定市望都县
保定市徐水区公安局	河北省保定市徐水区
保定市莲池区公安局	河北省保定市莲池区
保定市博野县公安局	河北省保定市博野县
保定市满城区公安局	河北省保定市满城区
保定市蠡县公安局	河北省保定市蠡县
保定市容城县公安局	河北省保定市容城县
保定市易县公安局	河北省保定市易县
保定市安国市公安局	河北省保定市安国市
保定市清苑区公安局	河北省保定市清苑区
保定市阜平县公安局	河北省保定市阜平县
保定市雄县公安局	河北省保定市雄县
保定市曲阳县公安局	河北省保定市曲阳县
保定市高阳县公安局	河北省保定市高阳县
保定市保定白沟新城公安局	河北省保定市保定白沟新城
保定市竞秀区公安局	河北省保定市竞秀区
承德市隆化县公安局	河北省承德市隆化县
承德市承德高新技术产业开发区公安局	河北省承德市承德高新技术产业开发区
承德市平泉市公安局	河北省承德市平泉市
承德市鹰手营子矿区公安局	河北省承德市鹰手营子矿区
承德市承德县公安局	河北省承德市承德县
承德市围场满族蒙古族自治县公安局	河北省承德市围场满族蒙古族自治县
承德市双滦区公安局	河北省承德市双滦区
承德市滦平县公安局	河北省承德市滦平县
承德市兴隆县公安局	河北省承德市兴隆县
承德市双桥区公安局	河北省承德市双桥区
承德市宽城满族自治县公安局	河北省承德市宽城满族自治县
承德市丰宁满族自治县公安局	河北省承德市丰宁满族自治县
张家口市下花园区公安局	河北省张家口市下花园区
张家口市张家口市塞北管理区公安局	河北省张家口市张家口市塞北管理区
张家口市张北县公安局	河北省张家口市张北县
张家口市怀来县公安局	河北省张家口市怀来县
张家口市万全区公安局	河北省张家口市万全区
张家口市崇礼区公安局	河北省张家口市崇礼区
张家口市康保县公安局	河北省张家口市康保县
张家口市蔚县公安局	河北省张家口市蔚县
张家口市怀安县公安局	河北省张家口市怀安县
张家口市张家口市高新技术产业开发区公安局	河北省张家口市张家口市高新技术产业开发区
张家口市宣化区公安局	河北省张家口市宣化区
张家口市赤城县公安局	河北省张家口市赤城县
张家口市张家口市察北管理区公安局	河北省张家口市张家口市察北管理区
张家口市尚义县公安局	河北省张家口市尚义县
张家口市涿鹿县公安局	河北省张家口市涿鹿县
张家口市桥西区公安局	河北省张家口市桥西区
张家口市桥东区公安局	河北省张家口市桥东区
张家口市阳原县公安局	河北省张家口市阳原县
张家口市沽源县公安局	河北省张家口市沽源县
邯郸市永年区公安局	河北省邯郸市永年区
邯郸市肥乡区公安局	河北省邯郸市肥乡区
邯郸市馆陶县公安局	河北省邯郸市馆陶县
邯郸市丛台区公安局	河北省邯郸市丛台区
邯郸市成安县公安局	河北省邯郸市成安县
邯郸市邱县公安局	河北省邯郸市邱县
邯郸市魏县公安局	河北省邯郸市魏县
邯郸市临漳县公安局	河北省邯郸市临漳县
邯郸市磁县公安局	河北省邯郸市磁县
邯郸市曲周县公安局	河北省邯郸市曲周县
邯郸市鸡泽县公安局	河北省邯郸市鸡泽县
邯郸市邯山区公安局	河北省邯郸市邯山区
邯郸市涉县公安局	河北省邯郸市涉县
邯郸市广平县公安局	河北省邯郸市广平县
邯郸市峰峰矿区公安局	河北省邯郸市峰峰矿区
邯郸市邯郸冀南新区公安局	河北省邯郸市邯郸冀南新区
邯郸市大名县公安局	河北省邯郸市大名县
邯郸市武安市公安局	河北省邯郸市武安市
邯郸市复兴区公安局	河北省邯郸市复兴区
邯郸市邯郸经济技术开发区公安局	河北省邯郸市邯郸经济技术开发区
石家庄市井陉县公安局	河北省石家庄市井陉县
石家庄市藁城区公安局	河北省石家庄市藁城区
石家庄市裕华区公安局	河北省石家庄市裕华区
石家庄市平山县公安局	河北省石家庄市平山县
石家庄市灵寿县公安局	河北省石家庄市灵寿县
石家庄市赵县公安局	河北省石家庄市赵县
石家庄市石家庄高新技术产业开发区公安局	河北省石家庄市石家庄高新技术产业开发区
石家庄市井陉矿区公安局	河北省石家庄市井陉矿区
石家庄市新乐市公安局	河北省石家庄市新乐市
石家庄市鹿泉区公安局	河北省石家庄市鹿泉区
石家庄市栾城区公安局	河北省石家庄市栾城区
石家庄市长安区公安局	河北省石家庄市长安区
石家庄市辛集市公安局	河北省石家庄市辛集市
石家庄市晋州市公安局	河北省石家庄市晋州市
石家庄市石家庄循环化工园区公安局	河北省石家庄市石家庄循环化工园区
石家庄市深泽县公安局	河北省石家庄市深泽县
石家庄市桥西区公安局	河北省石家庄市桥西区
石家庄市正定县公安局	河北省石家庄市正定县
石家庄市新华区公安局	河北省石家庄市新华区
石家庄市赞皇县公安局	河北省石家庄市赞皇县
石家庄市无极县公安局	河北省石家庄市无极县
石家庄市元氏县公安局	河北省石家庄市元氏县
石家庄市高邑县公安局	河北省石家庄市高邑县
石家庄市行唐县公安局	河北省石家庄市行唐县
沧州市河北沧州经济开发区公安局	河北省沧州市河北沧州经济开发区
沧州市运河区公安局	河北省沧州市运河区
沧州市青县公安局	河北省沧州市青县
沧州市河间市公安局	河北省沧州市河间市
沧州市孟村回族自治县公安局	河北省沧州市孟村回族自治县
沧州市黄骅市公安局	河北省沧州市黄骅市
沧州市东光县公安局	河北省沧州市东光县
沧州市沧县公安局	河北省沧州市沧县
沧州市沧州高新技术产业开发区公安局	河北省沧州市沧州高新技术产业开发区
沧州市新华区公安局	河北省沧州市新华区
沧州市泊头市公安局	河北省沧州市泊头市
沧州市盐山县公安局	河北省沧州市盐山县
沧州市南皮县公安局	河北省沧州市南皮县
沧州市献县公安局	河北省沧州市献县
沧州市沧州渤海新区公安局	河北省沧州市沧州渤海新区
沧州市肃宁县公安局	河北省沧州市肃宁县
沧州市任丘市公安局	河北省沧州市任丘市
沧州市吴桥县公安局	河北省沧州市吴桥县
沧州市海兴县公安局	河北省沧州市海兴县
廊坊市安次区公安局	河北省廊坊市安次区
廊坊市广阳区公安局	河北省廊坊市广阳区
廊坊市文安县公安局	河北省廊坊市文安县
廊坊市三河市公安局	河北省廊坊市三河市
廊坊市大城县公安局	河北省廊坊市大城县
廊坊市香河县公安局	河北省廊坊市香河县
廊坊市霸州市公安局	河北省廊坊市霸州市
廊坊市永清县公安局	河北省廊坊市永清县
廊坊市大厂回族自治县公安局	河北省廊坊市大厂回族自治县
廊坊市固安县公安局	河北省廊坊市固安县
廊坊市廊坊经济技术开发区公安局	河北省廊坊市廊坊经济技术开发区
通化市辉南县公安局	吉林省通化市辉南县
通化市东昌区公安局	吉林省通化市东昌区
通化市二道江区公安局	吉林省通化市二道江区
通化市通化县公安局	吉林省通化市通化县
通化市梅河口市公安局	吉林省通化市梅河口市
通化市集安市公安局	吉林省通化市集安市
通化市柳河县公安局	吉林省通化市柳河县
延边朝鲜族自治州敦化市公安局	吉林省延边朝鲜族自治州敦化市
延边朝鲜族自治州图们市公安局	吉林省延边朝鲜族自治州图们市
延边朝鲜族自治州延吉市公安局	吉林省延边朝鲜族自治州延吉市
白山市长白朝鲜族自治县公安局	吉林省白山市长白朝鲜族自治县
白山市抚松县公安局	吉林省白山市抚松县
白山市江源区公安局	吉林省白山市江源区
白山市靖宇县公安局	吉林省白山市靖宇县
白山市临江市公安局	吉林省白山市临江市
白山市浑江区公安局	吉林省白山市浑江区
长春市九台区公安局	吉林省长春市九台区
长春市长春高新技术产业开发区公安局	吉林省长春市长春高新技术产业开发区
长春市长春汽车经济技术开发区公安局	吉林省长春市长春汽车经济技术开发区
长春市绿园区公安局	吉林省长春市绿园区
长春市德惠市公安局	吉林省长春市德惠市
长春市南关区公安局	吉林省长春市南关区
长春市榆树市公安局	吉林省长春市榆树市
长春市农安县公安局	吉林省长春市农安县
长春市朝阳区公安局	吉林省长春市朝阳区
长春市二道区公安局	吉林省长春市二道区
长春市长春经济技术开发区公安局	吉林省长春市长春经济技术开发区
长春市宽城区公安局	吉林省长春市宽城区
长春市双阳区公安局	吉林省长春市双阳区
长春市长春净月高新技术产业开发区公安局	吉林省长春市长春净月高新技术产业开发区
松原市乾安县公安局	吉林省松原市乾安县
松原市前郭尔罗斯蒙古族自治县公安局	吉林省松原市前郭尔罗斯蒙古族自治县
松原市吉林松原经济开发区公安局	吉林省松原市吉林松原经济开发区
松原市长岭县公安局	吉林省松原市长岭县
松原市宁江区公安局	吉林省松原市宁江区
松原市扶余市公安局	吉林省松原市扶余市
四平市双辽市公安局	吉林省四平市双辽市
四平市铁东区公安局	吉林省四平市铁东区
四平市梨树县公安局	吉林省四平市梨树县
四平市铁西区公安局	吉林省四平市铁西区
四平市公主岭市公安局	吉林省四平市公主岭市
四平市伊通满族自治县公安局	吉林省四平市伊通满族自治县
玉溪市通海县公安局	云南省玉溪市通海县
玉溪市新平彝族傣族自治县公安局	云南省玉溪市新平彝族傣族自治县
玉溪市澄江县公安局	云南省玉溪市澄江县
玉溪市江川区公安局	云南省玉溪市江川区
玉溪市易门县公安局	云南省玉溪市易门县
玉溪市峨山彝族自治县公安局	云南省玉溪市峨山彝族自治县
玉溪市华宁县公安局	云南省玉溪市华宁县
玉溪市红塔区公安局	云南省玉溪市红塔区
玉溪市元江哈尼族彝族傣族自治县公安局	云南省玉溪市元江哈尼族彝族傣族自治县
昭通市巧家县公安局	云南省昭通市巧家县
昭通市镇雄县公安局	云南省昭通市镇雄县
昭通市鲁甸县公安局	云南省昭通市鲁甸县
昭通市彝良县公安局	云南省昭通市彝良县
昭通市盐津县公安局	云南省昭通市盐津县
昭通市永善县公安局	云南省昭通市永善县
昭通市昭阳区公安局	云南省昭通市昭阳区
昭通市威信县公安局	云南省昭通市威信县
昭通市水富市公安局	云南省昭通市水富市
昭通市大关县公安局	云南省昭通市大关县
昭通市绥江县公安局	云南省昭通市绥江县
德宏傣族景颇族自治州瑞丽市公安局	云南省德宏傣族景颇族自治州瑞丽市
德宏傣族景颇族自治州芒市公安局	云南省德宏傣族景颇族自治州芒市
德宏傣族景颇族自治州陇川县公安局	云南省德宏傣族景颇族自治州陇川县
德宏傣族景颇族自治州梁河县公安局	云南省德宏傣族景颇族自治州梁河县
德宏傣族景颇族自治州盈江县公安局	云南省德宏傣族景颇族自治州盈江县
迪庆藏族自治州香格里拉市公安局	云南省迪庆藏族自治州香格里拉市
迪庆藏族自治州德钦县公安局	云南省迪庆藏族自治州德钦县
迪庆藏族自治州维西傈僳族自治县公安局	云南省迪庆藏族自治州维西傈僳族自治县
临沧市临翔区公安局	云南省临沧市临翔区
临沧市耿马傣族佤族自治县公安局	云南省临沧市耿马傣族佤族自治县
临沧市凤庆县公安局	云南省临沧市凤庆县
临沧市云县公安局	云南省临沧市云县
临沧市镇康县公安局	云南省临沧市镇康县
临沧市沧源佤族自治县公安局	云南省临沧市沧源佤族自治县
临沧市永德县公安局	云南省临沧市永德县
临沧市双江拉祜族佤族布朗族傣族自治县公安局	云南省临沧市双江拉祜族佤族布朗族傣族自治县
普洱市镇沅彝族哈尼族拉祜族自治县公安局	云南省普洱市镇沅彝族哈尼族拉祜族自治县
普洱市景谷傣族彝族自治县公安局	云南省普洱市景谷傣族彝族自治县
普洱市澜沧拉祜族自治县公安局	云南省普洱市澜沧拉祜族自治县
普洱市江城哈尼族彝族自治县公安局	云南省普洱市江城哈尼族彝族自治县
普洱市孟连傣族拉祜族佤族自治县公安局	云南省普洱市孟连傣族拉祜族佤族自治县
普洱市景东彝族自治县公安局	云南省普洱市景东彝族自治县
普洱市思茅区公安局	云南省普洱市思茅区
普洱市墨江哈尼族自治县公安局	云南省普洱市墨江哈尼族自治县
普洱市西盟佤族自治县公安局	云南省普洱市西盟佤族自治县
普洱市宁洱哈尼族彝族自治县公安局	云南省普洱市宁洱哈尼族彝族自治县
大理白族自治州剑川县公安局	云南省大理白族自治州剑川县
大理白族自治州宾川县公安局	云南省大理白族自治州宾川县
大理白族自治州鹤庆县公安局	云南省大理白族自治州鹤庆县
大理白族自治州大理市公安局	云南省大理白族自治州大理市
大理白族自治州洱源县公安局	云南省大理白族自治州洱源县
大理白族自治州巍山彝族回族自治县公安局	云南省大理白族自治州巍山彝族回族自治县
大理白族自治州永平县公安局	云南省大理白族自治州永平县
大理白族自治州弥渡县公安局	云南省大理白族自治州弥渡县
大理白族自治州漾濞彝族自治县公安局	云南省大理白族自治州漾濞彝族自治县
大理白族自治州祥云县公安局	云南省大理白族自治州祥云县
大理白族自治州南涧彝族自治县公安局	云南省大理白族自治州南涧彝族自治县
大理白族自治州云龙县公安局	云南省大理白族自治州云龙县
文山壮族苗族自治州麻栗坡县公安局	云南省文山壮族苗族自治州麻栗坡县
文山壮族苗族自治州文山市公安局	云南省文山壮族苗族自治州文山市
文山壮族苗族自治州马关县公安局	云南省文山壮族苗族自治州马关县
文山壮族苗族自治州丘北县公安局	云南省文山壮族苗族自治州丘北县
文山壮族苗族自治州广南县公安局	云南省文山壮族苗族自治州广南县
文山壮族苗族自治州富宁县公安局	云南省文山壮族苗族自治州富宁县
文山壮族苗族自治州砚山县公安局	云南省文山壮族苗族自治州砚山县
文山壮族苗族自治州西畴县公安局	云南省文山壮族苗族自治州西畴县
楚雄彝族自治州南华县公安局	云南省楚雄彝族自治州南华县
楚雄彝族自治州永仁县公安局	云南省楚雄彝族自治州永仁县
楚雄彝族自治州元谋县公安局	云南省楚雄彝族自治州元谋县
楚雄彝族自治州武定县公安局	云南省楚雄彝族自治州武定县
楚雄彝族自治州楚雄市公安局	云南省楚雄彝族自治州楚雄市
楚雄彝族自治州禄丰县公安局	云南省楚雄彝族自治州禄丰县
楚雄彝族自治州姚安县公安局	云南省楚雄彝族自治州姚安县
楚雄彝族自治州牟定县公安局	云南省楚雄彝族自治州牟定县
楚雄彝族自治州大姚县公安局	云南省楚雄彝族自治州大姚县
楚雄彝族自治州双柏县公安局	云南省楚雄彝族自治州双柏县
丽江市宁蒗彝族自治县公安局	云南省丽江市宁蒗彝族自治县
丽江市古城区公安局	云南省丽江市古城区
丽江市华坪县公安局	云南省丽江市华坪县
丽江市玉龙纳西族自治县公安局	云南省丽江市玉龙纳西族自治县
丽江市永胜县公安局	云南省丽江市永胜县
曲靖市沾益区公安局	云南省曲靖市沾益区
曲靖市宣威市公安局	云南省曲靖市宣威市
曲靖市马龙区公安局	云南省曲靖市马龙区
曲靖市师宗县公安局	云南省曲靖市师宗县
曲靖市罗平县公安局	云南省曲靖市罗平县
曲靖市麒麟区公安局	云南省曲靖市麒麟区
曲靖市富源县公安局	云南省曲靖市富源县
和田地区策勒县公安局	新疆维吾尔自治区和田地区策勒县
和田地区墨玉县公安局	新疆维吾尔自治区和田地区墨玉县
和田地区皮山县公安局	新疆维吾尔自治区和田地区皮山县
和田地区和田县公安局	新疆维吾尔自治区和田地区和田县
和田地区和田市公安局	新疆维吾尔自治区和田地区和田市
和田地区洛浦县公安局	新疆维吾尔自治区和田地区洛浦县
和田地区于田县公安局	新疆维吾尔自治区和田地区于田县
和田地区民丰县公安局	新疆维吾尔自治区和田地区民丰县
自治区直辖县级行政区划图木舒克市公安局	新疆维吾尔自治区自治区直辖县级行政区划图木舒克市
自治区直辖县级行政区划阿拉尔市公安局	新疆维吾尔自治区自治区直辖县级行政区划阿拉尔市
自治区直辖县级行政区划铁门关市公安局	新疆维吾尔自治区自治区直辖县级行政区划铁门关市
自治区直辖县级行政区划五家渠市公安局	新疆维吾尔自治区自治区直辖县级行政区划五家渠市
自治区直辖县级行政区划石河子市公安局	新疆维吾尔自治区自治区直辖县级行政区划石河子市
喀什地区莎车县公安局	新疆维吾尔自治区喀什地区莎车县
喀什地区伽师县公安局	新疆维吾尔自治区喀什地区伽师县
喀什地区喀什市公安局	新疆维吾尔自治区喀什地区喀什市
喀什地区英吉沙县公安局	新疆维吾尔自治区喀什地区英吉沙县
喀什地区疏附县公安局	新疆维吾尔自治区喀什地区疏附县
喀什地区岳普湖县公安局	新疆维吾尔自治区喀什地区岳普湖县
喀什地区叶城县公安局	新疆维吾尔自治区喀什地区叶城县
海口市琼山区公安局	海南省海口市琼山区
海口市美兰区公安局	海南省海口市美兰区
海口市秀英区公安局	海南省海口市秀英区
海口市龙华区公安局	海南省海口市龙华区
市辖区密云区公安局	北京市市辖区密云区
市辖区西城区公安局	北京市市辖区西城区
市辖区东城区公安局	北京市市辖区东城区
市辖区门头沟区公安局	北京市市辖区门头沟区
市辖区海淀区公安局	北京市市辖区海淀区
市辖区房山区公安局	北京市市辖区房山区
市辖区昌平区公安局	北京市市辖区昌平区
市辖区延庆区公安局	北京市市辖区延庆区
市辖区石景山区公安局	北京市市辖区石景山区
市辖区顺义区公安局	北京市市辖区顺义区
市辖区大兴区公安局	北京市市辖区大兴区
市辖区平谷区公安局	北京市市辖区平谷区
市辖区通州区公安局	北京市市辖区通州区
市辖区朝阳区公安局	北京市市辖区朝阳区
市辖区丰台区公安局	北京市市辖区丰台区
市辖区怀柔区公安局	北京市市辖区怀柔区
汕头市金平区公安局	广东省汕头市金平区
汕头市龙湖区公安局	广东省汕头市龙湖区
咸阳市秦都区公安局	陕西省咸阳市秦都区
咸阳市泾阳县公安局	陕西省咸阳市泾阳县
咸阳市三原县公安局	陕西省咸阳市三原县
咸阳市乾县公安局	陕西省咸阳市乾县
咸阳市渭城区公安局	陕西省咸阳市渭城区
咸阳市礼泉县公安局	陕西省咸阳市礼泉县
咸阳市兴平市公安局	陕西省咸阳市兴平市
咸阳市杨陵区公安局	陕西省咸阳市杨陵区
咸阳市淳化县公安局	陕西省咸阳市淳化县
咸阳市武功县公安局	陕西省咸阳市武功县
咸阳市旬邑县公安局	陕西省咸阳市旬邑县
咸阳市永寿县公安局	陕西省咸阳市永寿县
咸阳市长武县公安局	陕西省咸阳市长武县
宝鸡市凤翔县公安局	陕西省宝鸡市凤翔县
宝鸡市眉县公安局	陕西省宝鸡市眉县
宝鸡市岐山县公安局	陕西省宝鸡市岐山县
宝鸡市麟游县公安局	陕西省宝鸡市麟游县
宝鸡市陈仓区公安局	陕西省宝鸡市陈仓区
宝鸡市渭滨区公安局	陕西省宝鸡市渭滨区
宝鸡市千阳县公安局	陕西省宝鸡市千阳县
宝鸡市金台区公安局	陕西省宝鸡市金台区
宝鸡市太白县公安局	陕西省宝鸡市太白县
宝鸡市凤县公安局	陕西省宝鸡市凤县
宝鸡市扶风县公安局	陕西省宝鸡市扶风县
宝鸡市陇县公安局	陕西省宝鸡市陇县
汉中市佛坪县公安局	陕西省汉中市佛坪县
汉中市略阳县公安局	陕西省汉中市略阳县
汉中市镇巴县公安局	陕西省汉中市镇巴县
汉中市洋县公安局	陕西省汉中市洋县
汉中市西乡县公安局	陕西省汉中市西乡县
汉中市城固县公安局	陕西省汉中市城固县
汉中市宁强县公安局	陕西省汉中市宁强县
汉中市南郑区公安局	陕西省汉中市南郑区
汉中市汉台区公安局	陕西省汉中市汉台区
汉中市留坝县公安局	陕西省汉中市留坝县
汉中市勉县公安局	陕西省汉中市勉县
安康市汉滨区公安局	陕西省安康市汉滨区
安康市紫阳县公安局	陕西省安康市紫阳县
安康市岚皋县公安局	陕西省安康市岚皋县
安康市旬阳县公安局	陕西省安康市旬阳县
安康市宁陕县公安局	陕西省安康市宁陕县
安康市汉阴县公安局	陕西省安康市汉阴县
安康市镇坪县公安局	陕西省安康市镇坪县
安康市石泉县公安局	陕西省安康市石泉县
安康市平利县公安局	陕西省安康市平利县
安康市白河县公安局	陕西省安康市白河县
商洛市丹凤县公安局	陕西省商洛市丹凤县
商洛市洛南县公安局	陕西省商洛市洛南县
商洛市镇安县公安局	陕西省商洛市镇安县
商洛市商南县公安局	陕西省商洛市商南县
商洛市柞水县公安局	陕西省商洛市柞水县
商洛市商州区公安局	陕西省商洛市商州区
商洛市山阳县公安局	陕西省商洛市山阳县
西安市高陵区公安局	陕西省西安市高陵区
西安市临潼区公安局	陕西省西安市临潼区
西安市雁塔区公安局	陕西省西安市雁塔区
西安市灞桥区公安局	陕西省西安市灞桥区
西安市新城区公安局	陕西省西安市新城区
西安市碑林区公安局	陕西省西安市碑林区
西安市蓝田县公安局	陕西省西安市蓝田县
西安市未央区公安局	陕西省西安市未央区
西安市鄠邑区公安局	陕西省西安市鄠邑区
西安市长安区公安局	陕西省西安市长安区
西安市阎良区公安局	陕西省西安市阎良区
西安市莲湖区公安局	陕西省西安市莲湖区
西安市周至县公安局	陕西省西安市周至县
延安市子长县公安局	陕西省延安市子长县
延安市志丹县公安局	陕西省延安市志丹县
延安市延长县公安局	陕西省延安市延长县
延安市延川县公安局	陕西省延安市延川县
延安市黄龙县公安局	陕西省延安市黄龙县
延安市宜川县公安局	陕西省延安市宜川县
延安市洛川县公安局	陕西省延安市洛川县
延安市吴起县公安局	陕西省延安市吴起县
延安市甘泉县公安局	陕西省延安市甘泉县
延安市富县公安局	陕西省延安市富县
延安市宝塔区公安局	陕西省延安市宝塔区
延安市安塞区公安局	陕西省延安市安塞区
延安市黄陵县公安局	陕西省延安市黄陵县
渭南市白水县公安局	陕西省渭南市白水县
渭南市华阴市公安局	陕西省渭南市华阴市
渭南市韩城市公安局	陕西省渭南市韩城市
渭南市合阳县公安局	陕西省渭南市合阳县
渭南市蒲城县公安局	陕西省渭南市蒲城县
渭南市华州区公安局	陕西省渭南市华州区
渭南市澄城县公安局	陕西省渭南市澄城县
渭南市潼关县公安局	陕西省渭南市潼关县
渭南市富平县公安局	陕西省渭南市富平县
渭南市临渭区公安局	陕西省渭南市临渭区
渭南市大荔县公安局	陕西省渭南市大荔县
铜川市王益区公安局	陕西省铜川市王益区
铜川市耀州区公安局	陕西省铜川市耀州区
铜川市宜君县公安局	陕西省铜川市宜君县
铜川市印台区公安局	陕西省铜川市印台区
驻马店市上蔡县公安局	河南省驻马店市上蔡县
驻马店市驿城区公安局	河南省驻马店市驿城区
驻马店市确山县公安局	河南省驻马店市确山县
驻马店市西平县公安局	河南省驻马店市西平县
驻马店市新蔡县公安局	河南省驻马店市新蔡县
驻马店市遂平县公安局	河南省驻马店市遂平县
驻马店市河南驻马店经济开发区公安局	河南省驻马店市河南驻马店经济开发区
驻马店市泌阳县公安局	河南省驻马店市泌阳县
驻马店市正阳县公安局	河南省驻马店市正阳县
驻马店市平舆县公安局	河南省驻马店市平舆县
驻马店市汝南县公安局	河南省驻马店市汝南县
洛阳市涧西区公安局	河南省洛阳市涧西区
洛阳市洛阳高新技术产业开发区公安局	河南省洛阳市洛阳高新技术产业开发区
洛阳市嵩县公安局	河南省洛阳市嵩县
洛阳市偃师市公安局	河南省洛阳市偃师市
洛阳市老城区公安局	河南省洛阳市老城区
洛阳市西工区公安局	河南省洛阳市西工区
洛阳市孟津县公安局	河南省洛阳市孟津县
洛阳市洛宁县公安局	河南省洛阳市洛宁县
洛阳市宜阳县公安局	河南省洛阳市宜阳县
洛阳市吉利区公安局	河南省洛阳市吉利区
洛阳市洛龙区公安局	河南省洛阳市洛龙区
洛阳市栾川县公安局	河南省洛阳市栾川县
洛阳市伊川县公安局	河南省洛阳市伊川县
洛阳市汝阳县公安局	河南省洛阳市汝阳县
洛阳市新安县公安局	河南省洛阳市新安县
洛阳市瀍河回族区公安局	河南省洛阳市瀍河回族区
新乡市卫滨区公安局	河南省新乡市卫滨区
新乡市延津县公安局	河南省新乡市延津县
新乡市新乡高新技术产业开发区公安局	河南省新乡市新乡高新技术产业开发区
新乡市封丘县公安局	河南省新乡市封丘县
新乡市辉县市公安局	河南省新乡市辉县市
新乡市牧野区公安局	河南省新乡市牧野区
新乡市原阳县公安局	河南省新乡市原阳县
新乡市新乡经济技术开发区公安局	河南省新乡市新乡经济技术开发区
新乡市红旗区公安局	河南省新乡市红旗区
新乡市凤泉区公安局	河南省新乡市凤泉区
新乡市获嘉县公安局	河南省新乡市获嘉县
新乡市新乡市平原城乡一体化示范区公安局	河南省新乡市新乡市平原城乡一体化示范区
新乡市新乡县公安局	河南省新乡市新乡县
新乡市卫辉市公安局	河南省新乡市卫辉市
新乡市长垣县公安局	河南省新乡市长垣县
漯河市舞阳县公安局	河南省漯河市舞阳县
漯河市郾城区公安局	河南省漯河市郾城区
漯河市召陵区公安局	河南省漯河市召陵区
漯河市漯河经济技术开发区公安局	河南省漯河市漯河经济技术开发区
漯河市临颍县公安局	河南省漯河市临颍县
漯河市源汇区公安局	河南省漯河市源汇区
南阳市社旗县公安局	河南省南阳市社旗县
南阳市邓州市公安局	河南省南阳市邓州市
南阳市卧龙区公安局	河南省南阳市卧龙区
南阳市西峡县公安局	河南省南阳市西峡县
南阳市南召县公安局	河南省南阳市南召县
南阳市宛城区公安局	河南省南阳市宛城区
南阳市唐河县公安局	河南省南阳市唐河县
南阳市南阳高新技术产业开发区公安局	河南省南阳市南阳高新技术产业开发区
南阳市方城县公安局	河南省南阳市方城县
南阳市新野县公安局	河南省南阳市新野县
南阳市桐柏县公安局	河南省南阳市桐柏县
南阳市镇平县公安局	河南省南阳市镇平县
南阳市淅川县公安局	河南省南阳市淅川县
南阳市南阳市城乡一体化示范区公安局	河南省南阳市南阳市城乡一体化示范区
南阳市内乡县公安局	河南省南阳市内乡县
周口市鹿邑县公安局	河南省周口市鹿邑县
周口市沈丘县公安局	河南省周口市沈丘县
周口市太康县公安局	河南省周口市太康县
周口市西华县公安局	河南省周口市西华县
周口市郸城县公安局	河南省周口市郸城县
周口市河南周口经济开发区公安局	河南省周口市河南周口经济开发区
周口市川汇区公安局	河南省周口市川汇区
周口市淮阳县公安局	河南省周口市淮阳县
周口市项城市公安局	河南省周口市项城市
周口市扶沟县公安局	河南省周口市扶沟县
周口市商水县公安局	河南省周口市商水县
安阳市安阳县公安局	河南省安阳市安阳县
安阳市龙安区公安局	河南省安阳市龙安区
安阳市安阳高新技术产业开发区公安局	河南省安阳市安阳高新技术产业开发区
安阳市汤阴县公安局	河南省安阳市汤阴县
安阳市文峰区公安局	河南省安阳市文峰区
安阳市北关区公安局	河南省安阳市北关区
安阳市殷都区公安局	河南省安阳市殷都区
安阳市滑县公安局	河南省安阳市滑县
安阳市内黄县公安局	河南省安阳市内黄县
安阳市林州市公安局	河南省安阳市林州市
开封市祥符区公安局	河南省开封市祥符区
开封市尉氏县公安局	河南省开封市尉氏县
开封市顺河回族区公安局	河南省开封市顺河回族区
开封市龙亭区公安局	河南省开封市龙亭区
开封市通许县公安局	河南省开封市通许县
开封市杞县公安局	河南省开封市杞县
开封市兰考县公安局	河南省开封市兰考县
开封市禹王台区公安局	河南省开封市禹王台区
开封市鼓楼区公安局	河南省开封市鼓楼区
商丘市睢阳区公安局	河南省商丘市睢阳区
商丘市睢县公安局	河南省商丘市睢县
商丘市柘城县公安局	河南省商丘市柘城县
商丘市虞城县公安局	河南省商丘市虞城县
商丘市豫东综合物流产业聚集区公安局	河南省商丘市豫东综合物流产业聚集区
商丘市宁陵县公安局	河南省商丘市宁陵县
商丘市梁园区公安局	河南省商丘市梁园区
商丘市夏邑县公安局	河南省商丘市夏邑县
商丘市民权县公安局	河南省商丘市民权县
商丘市河南商丘经济开发区公安局	河南省商丘市河南商丘经济开发区
商丘市永城市公安局	河南省商丘市永城市
濮阳市清丰县公安局	河南省濮阳市清丰县
濮阳市华龙区公安局	河南省濮阳市华龙区
濮阳市范县公安局	河南省濮阳市范县
濮阳市南乐县公安局	河南省濮阳市南乐县
濮阳市濮阳县公安局	河南省濮阳市濮阳县
濮阳市濮阳经济技术开发区公安局	河南省濮阳市濮阳经济技术开发区
濮阳市台前县公安局	河南省濮阳市台前县
濮阳市河南濮阳工业园区公安局	河南省濮阳市河南濮阳工业园区
郑州市巩义市公安局	河南省郑州市巩义市
郑州市管城回族区公安局	河南省郑州市管城回族区
郑州市新密市公安局	河南省郑州市新密市
郑州市惠济区公安局	河南省郑州市惠济区
郑州市荥阳市公安局	河南省郑州市荥阳市
郑州市登封市公安局	河南省郑州市登封市
郑州市上街区公安局	河南省郑州市上街区
郑州市郑州经济技术开发区公安局	河南省郑州市郑州经济技术开发区
郑州市二七区公安局	河南省郑州市二七区
郑州市郑州高新技术产业开发区公安局	河南省郑州市郑州高新技术产业开发区
郑州市郑州航空港经济综合实验区公安局	河南省郑州市郑州航空港经济综合实验区
郑州市中牟县公安局	河南省郑州市中牟县
郑州市中原区公安局	河南省郑州市中原区
郑州市金水区公安局	河南省郑州市金水区
郑州市新郑市公安局	河南省郑州市新郑市
鹤壁市山城区公安局	河南省鹤壁市山城区
鹤壁市淇县公安局	河南省鹤壁市淇县
鹤壁市浚县公安局	河南省鹤壁市浚县
鹤壁市鹤壁经济技术开发区公安局	河南省鹤壁市鹤壁经济技术开发区
鹤壁市鹤山区公安局	河南省鹤壁市鹤山区
鹤壁市淇滨区公安局	河南省鹤壁市淇滨区
信阳市信阳高新技术产业开发区公安局	河南省信阳市信阳高新技术产业开发区
信阳市新县公安局	河南省信阳市新县
信阳市光山县公安局	河南省信阳市光山县
信阳市淮滨县公安局	河南省信阳市淮滨县
信阳市固始县公安局	河南省信阳市固始县
信阳市浉河区公安局	河南省信阳市浉河区
信阳市潢川县公安局	河南省信阳市潢川县
信阳市商城县公安局	河南省信阳市商城县
信阳市平桥区公安局	河南省信阳市平桥区
信阳市息县公安局	河南省信阳市息县
信阳市罗山县公安局	河南省信阳市罗山县
焦作市武陟县公安局	河南省焦作市武陟县
焦作市修武县公安局	河南省焦作市修武县
焦作市孟州市公安局	河南省焦作市孟州市
焦作市焦作城乡一体化示范区公安局	河南省焦作市焦作城乡一体化示范区
焦作市沁阳市公安局	河南省焦作市沁阳市
焦作市温县公安局	河南省焦作市温县
焦作市博爱县公安局	河南省焦作市博爱县
焦作市山阳区公安局	河南省焦作市山阳区
焦作市解放区公安局	河南省焦作市解放区
焦作市马村区公安局	河南省焦作市马村区
焦作市中站区公安局	河南省焦作市中站区
平顶山市卫东区公安局	河南省平顶山市卫东区
平顶山市平顶山高新技术产业开发区公安局	河南省平顶山市平顶山高新技术产业开发区
平顶山市鲁山县公安局	河南省平顶山市鲁山县
平顶山市汝州市公安局	河南省平顶山市汝州市
平顶山市叶县公安局	河南省平顶山市叶县
平顶山市郏县公安局	河南省平顶山市郏县
平顶山市舞钢市公安局	河南省平顶山市舞钢市
平顶山市石龙区公安局	河南省平顶山市石龙区
平顶山市湛河区公安局	河南省平顶山市湛河区
平顶山市平顶山市新城区公安局	河南省平顶山市平顶山市新城区
平顶山市新华区公安局	河南省平顶山市新华区
平顶山市宝丰县公安局	河南省平顶山市宝丰县
省直辖县级行政区划济源市公安局	河南省省直辖县级行政区划济源市
许昌市襄城县公安局	河南省许昌市襄城县
许昌市鄢陵县公安局	河南省许昌市鄢陵县
许昌市禹州市公安局	河南省许昌市禹州市
许昌市许昌经济技术开发区公安局	河南省许昌市许昌经济技术开发区
许昌市建安区公安局	河南省许昌市建安区
许昌市长葛市公安局	河南省许昌市长葛市
许昌市魏都区公安局	河南省许昌市魏都区
三门峡市河南三门峡经济开发区公安局	河南省三门峡市河南三门峡经济开发区
三门峡市渑池县公安局	河南省三门峡市渑池县
三门峡市灵宝市公安局	河南省三门峡市灵宝市
三门峡市义马市公安局	河南省三门峡市义马市
三门峡市陕州区公安局	河南省三门峡市陕州区
三门峡市卢氏县公安局	河南省三门峡市卢氏县
三门峡市湖滨区公安局	河南省三门峡市湖滨区
市辖区南岸区公安局	重庆市市辖区南岸区
市辖区江津区公安局	重庆市市辖区江津区
市辖区綦江区公安局	重庆市市辖区綦江区
市辖区涪陵区公安局	重庆市市辖区涪陵区
市辖区永川区公安局	重庆市市辖区永川区
市辖区渝北区公安局	重庆市市辖区渝北区
市辖区黔江区公安局	重庆市市辖区黔江区
市辖区南川区公安局	重庆市市辖区南川区
市辖区潼南区公安局	重庆市市辖区潼南区
市辖区万州区公安局	重庆市市辖区万州区
市辖区巴南区公安局	重庆市市辖区巴南区
市辖区开州区公安局	重庆市市辖区开州区
市辖区大渡口区公安局	重庆市市辖区大渡口区
市辖区大足区公安局	重庆市市辖区大足区
市辖区铜梁区公安局	重庆市市辖区铜梁区
市辖区江北区公安局	重庆市市辖区江北区
市辖区荣昌区公安局	重庆市市辖区荣昌区
市辖区璧山区公安局	重庆市市辖区璧山区
市辖区九龙坡区公安局	重庆市市辖区九龙坡区
市辖区武隆区公安局	重庆市市辖区武隆区
市辖区长寿区公安局	重庆市市辖区长寿区
市辖区合川区公安局	重庆市市辖区合川区
市辖区梁平区公安局	重庆市市辖区梁平区
市辖区渝中区公安局	重庆市市辖区渝中区
市辖区北碚区公安局	重庆市市辖区北碚区
市辖区沙坪坝区公安局	重庆市市辖区沙坪坝区
县石柱土家族自治县公安局	重庆市县石柱土家族自治县
县彭水苗族土家族自治县公安局	重庆市县彭水苗族土家族自治县
县秀山土家族苗族自治县公安局	重庆市县秀山土家族苗族自治县
县丰都县公安局	重庆市县丰都县
县巫山县公安局	重庆市县巫山县
县酉阳土家族苗族自治县公安局	重庆市县酉阳土家族苗族自治县
县奉节县公安局	重庆市县奉节县
县云阳县公安局	重庆市县云阳县
县城口县公安局	重庆市县城口县
县巫溪县公安局	重庆市县巫溪县
县垫江县公安局	重庆市县垫江县
县忠县公安局	重庆市县忠县
南宁市江南区公安局	广西壮族自治区南宁市江南区
南宁市横县公安局	广西壮族自治区南宁市横县
南宁市邕宁区公安局	广西壮族自治区南宁市邕宁区
南宁市良庆区公安局	广西壮族自治区南宁市良庆区
南宁市宾阳县公安局	广西壮族自治区南宁市宾阳县
南宁市西乡塘区公安局	广西壮族自治区南宁市西乡塘区
南宁市马山县公安局	广西壮族自治区南宁市马山县
南宁市武鸣区公安局	广西壮族自治区南宁市武鸣区
南宁市兴宁区公安局	广西壮族自治区南宁市兴宁区
南宁市上林县公安局	广西壮族自治区南宁市上林县
南宁市青秀区公安局	广西壮族自治区南宁市青秀区
南宁市隆安县公安局	广西壮族自治区南宁市隆安县
崇左市龙州县公安局	广西壮族自治区崇左市龙州县
崇左市宁明县公安局	广西壮族自治区崇左市宁明县
崇左市扶绥县公安局	广西壮族自治区崇左市扶绥县
崇左市天等县公安局	广西壮族自治区崇左市天等县
崇左市江州区公安局	广西壮族自治区崇左市江州区
崇左市凭祥市公安局	广西壮族自治区崇左市凭祥市
崇左市大新县公安局	广西壮族自治区崇左市大新县
钦州市钦北区公安局	广西壮族自治区钦州市钦北区
钦州市灵山县公安局	广西壮族自治区钦州市灵山县
钦州市钦南区公安局	广西壮族自治区钦州市钦南区
钦州市浦北县公安局	广西壮族自治区钦州市浦北县
河池市金城江区公安局	广西壮族自治区河池市金城江区
河池市天峨县公安局	广西壮族自治区河池市天峨县
河池市大化瑶族自治县公安局	广西壮族自治区河池市大化瑶族自治县
河池市宜州区公安局	广西壮族自治区河池市宜州区
河池市东兰县公安局	广西壮族自治区河池市东兰县
河池市环江毛南族自治县公安局	广西壮族自治区河池市环江毛南族自治县
河池市都安瑶族自治县公安局	广西壮族自治区河池市都安瑶族自治县
河池市南丹县公安局	广西壮族自治区河池市南丹县
河池市凤山县公安局	广西壮族自治区河池市凤山县
河池市巴马瑶族自治县公安局	广西壮族自治区河池市巴马瑶族自治县
河池市罗城仫佬族自治县公安局	广西壮族自治区河池市罗城仫佬族自治县
北海市海城区公安局	广西壮族自治区北海市海城区
北海市铁山港区公安局	广西壮族自治区北海市铁山港区
北海市银海区公安局	广西壮族自治区北海市银海区
北海市合浦县公安局	广西壮族自治区北海市合浦县
贺州市平桂区公安局	广西壮族自治区贺州市平桂区
贺州市八步区公安局	广西壮族自治区贺州市八步区
贺州市钟山县公安局	广西壮族自治区贺州市钟山县
玉林市北流市公安局	广西壮族自治区玉林市北流市
玉林市玉州区公安局	广西壮族自治区玉林市玉州区
玉林市兴业县公安局	广西壮族自治区玉林市兴业县
玉林市陆川县公安局	广西壮族自治区玉林市陆川县
玉林市博白县公安局	广西壮族自治区玉林市博白县
玉林市福绵区公安局	广西壮族自治区玉林市福绵区
玉林市容县公安局	广西壮族自治区玉林市容县
防城港市上思县公安局	广西壮族自治区防城港市上思县
防城港市防城区公安局	广西壮族自治区防城港市防城区
防城港市东兴市公安局	广西壮族自治区防城港市东兴市
防城港市港口区公安局	广西壮族自治区防城港市港口区
桂林市灵川县公安局	广西壮族自治区桂林市灵川县
桂林市七星区公安局	广西壮族自治区桂林市七星区
桂林市秀峰区公安局	广西壮族自治区桂林市秀峰区
桂林市全州县公安局	广西壮族自治区桂林市全州县
桂林市灌阳县公安局	广西壮族自治区桂林市灌阳县
桂林市龙胜各族自治县公安局	广西壮族自治区桂林市龙胜各族自治县
桂林市永福县公安局	广西壮族自治区桂林市永福县
桂林市荔浦市公安局	广西壮族自治区桂林市荔浦市
桂林市阳朔县公安局	广西壮族自治区桂林市阳朔县
桂林市雁山区公安局	广西壮族自治区桂林市雁山区
桂林市平乐县公安局	广西壮族自治区桂林市平乐县
桂林市叠彩区公安局	广西壮族自治区桂林市叠彩区
桂林市资源县公安局	广西壮族自治区桂林市资源县
桂林市象山区公安局	广西壮族自治区桂林市象山区
桂林市临桂区公安局	广西壮族自治区桂林市临桂区
桂林市兴安县公安局	广西壮族自治区桂林市兴安县
桂林市恭城瑶族自治县公安局	广西壮族自治区桂林市恭城瑶族自治县
柳州市柳南区公安局	广西壮族自治区柳州市柳南区
柳州市柳北区公安局	广西壮族自治区柳州市柳北区
柳州市融安县公安局	广西壮族自治区柳州市融安县
柳州市柳江区公安局	广西壮族自治区柳州市柳江区
柳州市鱼峰区公安局	广西壮族自治区柳州市鱼峰区
柳州市鹿寨县公安局	广西壮族自治区柳州市鹿寨县
柳州市城中区公安局	广西壮族自治区柳州市城中区
柳州市三江侗族自治县公安局	广西壮族自治区柳州市三江侗族自治县
柳州市融水苗族自治县公安局	广西壮族自治区柳州市融水苗族自治县
柳州市柳城县公安局	广西壮族自治区柳州市柳城县
百色市右江区公安局	广西壮族自治区百色市右江区
百色市田林县公安局	广西壮族自治区百色市田林县
百色市田东县公安局	广西壮族自治区百色市田东县
百色市凌云县公安局	广西壮族自治区百色市凌云县
百色市平果县公安局	广西壮族自治区百色市平果县
百色市德保县公安局	广西壮族自治区百色市德保县
百色市乐业县公安局	广西壮族自治区百色市乐业县
百色市隆林各族自治县公安局	广西壮族自治区百色市隆林各族自治县
百色市西林县公安局	广西壮族自治区百色市西林县
百色市那坡县公安局	广西壮族自治区百色市那坡县
百色市田阳县公安局	广西壮族自治区百色市田阳县
百色市靖西市公安局	广西壮族自治区百色市靖西市
朔州市山阴县公安局	山西省朔州市山阴县
朔州市山西朔州经济开发区公安局	山西省朔州市山西朔州经济开发区
朔州市怀仁市公安局	山西省朔州市怀仁市
朔州市应县公安局	山西省朔州市应县
朔州市右玉县公安局	山西省朔州市右玉县
朔州市平鲁区公安局	山西省朔州市平鲁区
朔州市朔城区公安局	山西省朔州市朔城区
晋城市陵川县公安局	山西省晋城市陵川县
晋城市阳城县公安局	山西省晋城市阳城县
晋城市泽州县公安局	山西省晋城市泽州县
晋城市城区公安局	山西省晋城市城区
晋城市沁水县公安局	山西省晋城市沁水县
晋城市高平市公安局	山西省晋城市高平市
阳泉市盂县公安局	山西省阳泉市盂县
阳泉市城区公安局	山西省阳泉市城区
阳泉市平定县公安局	山西省阳泉市平定县
阳泉市矿区公安局	山西省阳泉市矿区
阳泉市郊区公安局	山西省阳泉市郊区
吕梁市中阳县公安局	山西省吕梁市中阳县
吕梁市孝义市公安局	山西省吕梁市孝义市
吕梁市汾阳市公安局	山西省吕梁市汾阳市
吕梁市临县公安局	山西省吕梁市临县
吕梁市兴县公安局	山西省吕梁市兴县
吕梁市交城县公安局	山西省吕梁市交城县
吕梁市文水县公安局	山西省吕梁市文水县
吕梁市交口县公安局	山西省吕梁市交口县
吕梁市石楼县公安局	山西省吕梁市石楼县
吕梁市方山县公安局	山西省吕梁市方山县
吕梁市柳林县公安局	山西省吕梁市柳林县
吕梁市岚县公安局	山西省吕梁市岚县
吕梁市离石区公安局	山西省吕梁市离石区
太原市尖草坪区公安局	山西省太原市尖草坪区
太原市清徐县公安局	山西省太原市清徐县
太原市杏花岭区公安局	山西省太原市杏花岭区
太原市小店区公安局	山西省太原市小店区
太原市山西转型综合改革示范区公安局	山西省太原市山西转型综合改革示范区
太原市晋源区公安局	山西省太原市晋源区
太原市万柏林区公安局	山西省太原市万柏林区
太原市娄烦县公安局	山西省太原市娄烦县
太原市古交市公安局	山西省太原市古交市
太原市迎泽区公安局	山西省太原市迎泽区
太原市阳曲县公安局	山西省太原市阳曲县
长治市沁源县公安局	山西省长治市沁源县
长治市上党区公安局	山西省长治市上党区
长治市襄垣县公安局	山西省长治市襄垣县
长治市沁县公安局	山西省长治市沁县
长治市武乡县公安局	山西省长治市武乡县
长治市平顺县公安局	山西省长治市平顺县
长治市壶关县公安局	山西省长治市壶关县
长治市潞城区公安局	山西省长治市潞城区
长治市山西长治高新技术产业园区公安局	山西省长治市山西长治高新技术产业园区
长治市黎城县公安局	山西省长治市黎城县
长治市长子县公安局	山西省长治市长子县
长治市潞州区公安局	山西省长治市潞州区
长治市屯留区公安局	山西省长治市屯留区
临汾市永和县公安局	山西省临汾市永和县
临汾市尧都区公安局	山西省临汾市尧都区
临汾市翼城县公安局	山西省临汾市翼城县
临汾市乡宁县公安局	山西省临汾市乡宁县
临汾市安泽县公安局	山西省临汾市安泽县
临汾市霍州市公安局	山西省临汾市霍州市
临汾市古县公安局	山西省临汾市古县
临汾市洪洞县公安局	山西省临汾市洪洞县
临汾市隰县公安局	山西省临汾市隰县
临汾市侯马市公安局	山西省临汾市侯马市
临汾市襄汾县公安局	山西省临汾市襄汾县
临汾市曲沃县公安局	山西省临汾市曲沃县
临汾市浮山县公安局	山西省临汾市浮山县
临汾市蒲县公安局	山西省临汾市蒲县
临汾市大宁县公安局	山西省临汾市大宁县
临汾市吉县公安局	山西省临汾市吉县
临汾市汾西县公安局	山西省临汾市汾西县
晋中市平遥县公安局	山西省晋中市平遥县
晋中市左权县公安局	山西省晋中市左权县
晋中市寿阳县公安局	山西省晋中市寿阳县
晋中市和顺县公安局	山西省晋中市和顺县
晋中市祁县公安局	山西省晋中市祁县
晋中市灵石县公安局	山西省晋中市灵石县
晋中市榆次区公安局	山西省晋中市榆次区
晋中市昔阳县公安局	山西省晋中市昔阳县
晋中市榆社县公安局	山西省晋中市榆社县
晋中市太谷县公安局	山西省晋中市太谷县
晋中市介休市公安局	山西省晋中市介休市
大同市阳高县公安局	山西省大同市阳高县
大同市山西大同经济开发区公安局	山西省大同市山西大同经济开发区
大同市平城区公安局	山西省大同市平城区
大同市灵丘县公安局	山西省大同市灵丘县
大同市天镇县公安局	山西省大同市天镇县
大同市云冈区公安局	山西省大同市云冈区
大同市新荣区公安局	山西省大同市新荣区
大同市云州区公安局	山西省大同市云州区
大同市广灵县公安局	山西省大同市广灵县
大同市浑源县公安局	山西省大同市浑源县
大同市左云县公安局	山西省大同市左云县
运城市平陆县公安局	山西省运城市平陆县
运城市盐湖区公安局	山西省运城市盐湖区
运城市万荣县公安局	山西省运城市万荣县
运城市夏县公安局	山西省运城市夏县
运城市永济市公安局	山西省运城市永济市
运城市芮城县公安局	山西省运城市芮城县
运城市稷山县公安局	山西省运城市稷山县
运城市新绛县公安局	山西省运城市新绛县
运城市河津市公安局	山西省运城市河津市
运城市临猗县公安局	山西省运城市临猗县
运城市绛县公安局	山西省运城市绛县
运城市闻喜县公安局	山西省运城市闻喜县
运城市垣曲县公安局	山西省运城市垣曲县
忻州市岢岚县公安局	山西省忻州市岢岚县
忻州市定襄县公安局	山西省忻州市定襄县
忻州市五台县公安局	山西省忻州市五台县
忻州市宁武县公安局	山西省忻州市宁武县
忻州市忻府区公安局	山西省忻州市忻府区
忻州市代县公安局	山西省忻州市代县
忻州市五寨县公安局	山西省忻州市五寨县
忻州市繁峙县公安局	山西省忻州市繁峙县
忻州市神池县公安局	山西省忻州市神池县
忻州市保德县公安局	山西省忻州市保德县
忻州市偏关县公安局	山西省忻州市偏关县
忻州市原平市公安局	山西省忻州市原平市
忻州市河曲县公安局	山西省忻州市河曲县
忻州市五台山风景名胜区公安局	山西省忻州市五台山风景名胜区
忻州市静乐县公安局	山西省忻州市静乐县
红河哈尼族彝族自治州红河县公安局	云南省红河哈尼族彝族自治州红河县
红河哈尼族彝族自治州建水县公安局	云南省红河哈尼族彝族自治州建水县
红河哈尼族彝族自治州石屏县公安局	云南省红河哈尼族彝族自治州石屏县
红河哈尼族彝族自治州屏边苗族自治县公安局	云南省红河哈尼族彝族自治州屏边苗族自治县
红河哈尼族彝族自治州河口瑶族自治县公安局	云南省红河哈尼族彝族自治州河口瑶族自治县
红河哈尼族彝族自治州个旧市公安局	云南省红河哈尼族彝族自治州个旧市
红河哈尼族彝族自治州蒙自市公安局	云南省红河哈尼族彝族自治州蒙自市
红河哈尼族彝族自治州泸西县公安局	云南省红河哈尼族彝族自治州泸西县
红河哈尼族彝族自治州元阳县公安局	云南省红河哈尼族彝族自治州元阳县
红河哈尼族彝族自治州开远市公安局	云南省红河哈尼族彝族自治州开远市
红河哈尼族彝族自治州弥勒市公安局	云南省红河哈尼族彝族自治州弥勒市
红河哈尼族彝族自治州绿春县公安局	云南省红河哈尼族彝族自治州绿春县
红河哈尼族彝族自治州金平苗族瑶族傣族自治县公安局	云南省红河哈尼族彝族自治州金平苗族瑶族傣族自治县
西双版纳傣族自治州景洪市公安局	云南省西双版纳傣族自治州景洪市
西双版纳傣族自治州勐海县公安局	云南省西双版纳傣族自治州勐海县
西双版纳傣族自治州勐腊县公安局	云南省西双版纳傣族自治州勐腊县
昆明市晋宁区公安局	云南省昆明市晋宁区
昆明市安宁市公安局	云南省昆明市安宁市
昆明市宜良县公安局	云南省昆明市宜良县
昆明市官渡区公安局	云南省昆明市官渡区
昆明市东川区公安局	云南省昆明市东川区
昆明市禄劝彝族苗族自治县公安局	云南省昆明市禄劝彝族苗族自治县
昆明市石林彝族自治县公安局	云南省昆明市石林彝族自治县
昆明市富民县公安局	云南省昆明市富民县
昆明市五华区公安局	云南省昆明市五华区
昆明市呈贡区公安局	云南省昆明市呈贡区
昆明市西山区公安局	云南省昆明市西山区
昆明市寻甸回族彝族自治县公安局	云南省昆明市寻甸回族彝族自治县
昆明市嵩明县公安局	云南省昆明市嵩明县
昆明市盘龙区公安局	云南省昆明市盘龙区
保山市腾冲市公安局	云南省保山市腾冲市
保山市施甸县公安局	云南省保山市施甸县
保山市龙陵县公安局	云南省保山市龙陵县
保山市昌宁县公安局	云南省保山市昌宁县
保山市隆阳区公安局	云南省保山市隆阳区
省直辖县级行政区划陵水黎族自治县公安局	海南省省直辖县级行政区划陵水黎族自治县
省直辖县级行政区划白沙黎族自治县公安局	海南省省直辖县级行政区划白沙黎族自治县
省直辖县级行政区划东方市公安局	海南省省直辖县级行政区划东方市
省直辖县级行政区划临高县公安局	海南省省直辖县级行政区划临高县
省直辖县级行政区划乐东黎族自治县公安局	海南省省直辖县级行政区划乐东黎族自治县
省直辖县级行政区划琼中黎族苗族自治县公安局	海南省省直辖县级行政区划琼中黎族苗族自治县
省直辖县级行政区划保亭黎族苗族自治县公安局	海南省省直辖县级行政区划保亭黎族苗族自治县
省直辖县级行政区划万宁市公安局	海南省省直辖县级行政区划万宁市
省直辖县级行政区划澄迈县公安局	海南省省直辖县级行政区划澄迈县
省直辖县级行政区划屯昌县公安局	海南省省直辖县级行政区划屯昌县
省直辖县级行政区划定安县公安局	海南省省直辖县级行政区划定安县
省直辖县级行政区划文昌市公安局	海南省省直辖县级行政区划文昌市
省直辖县级行政区划琼海市公安局	海南省省直辖县级行政区划琼海市
省直辖县级行政区划昌江黎族自治县公安局	海南省省直辖县级行政区划昌江黎族自治县
省直辖县级行政区划五指山市公安局	海南省省直辖县级行政区划五指山市
儋州市儋州市公安局	海南省儋州市儋州市
三沙市南沙群岛公安局	海南省三沙市南沙群岛
三沙市中沙群岛的岛礁及其海域公安局	海南省三沙市中沙群岛的岛礁及其海域
三沙市西沙群岛公安局	海南省三沙市西沙群岛
遂宁市射洪县公安局	四川省遂宁市射洪县
遂宁市安居区公安局	四川省遂宁市安居区
遂宁市船山区公安局	四川省遂宁市船山区
遂宁市蓬溪县公安局	四川省遂宁市蓬溪县
遂宁市大英县公安局	四川省遂宁市大英县
资阳市乐至县公安局	四川省资阳市乐至县
资阳市雁江区公安局	四川省资阳市雁江区
资阳市安岳县公安局	四川省资阳市安岳县
绵阳市平武县公安局	四川省绵阳市平武县
绵阳市涪城区公安局	四川省绵阳市涪城区
绵阳市梓潼县公安局	四川省绵阳市梓潼县
绵阳市北川羌族自治县公安局	四川省绵阳市北川羌族自治县
绵阳市游仙区公安局	四川省绵阳市游仙区
绵阳市安州区公安局	四川省绵阳市安州区
绵阳市三台县公安局	四川省绵阳市三台县
绵阳市江油市公安局	四川省绵阳市江油市
绵阳市盐亭县公安局	四川省绵阳市盐亭县
泸州市江阳区公安局	四川省泸州市江阳区
泸州市泸县公安局	四川省泸州市泸县
泸州市纳溪区公安局	四川省泸州市纳溪区
泸州市古蔺县公安局	四川省泸州市古蔺县
泸州市合江县公安局	四川省泸州市合江县
泸州市叙永县公安局	四川省泸州市叙永县
泸州市龙马潭区公安局	四川省泸州市龙马潭区
攀枝花市仁和区公安局	四川省攀枝花市仁和区
攀枝花市西区公安局	四川省攀枝花市西区
攀枝花市米易县公安局	四川省攀枝花市米易县
攀枝花市盐边县公安局	四川省攀枝花市盐边县
攀枝花市东区公安局	四川省攀枝花市东区
南充市南部县公安局	四川省南充市南部县
南充市蓬安县公安局	四川省南充市蓬安县
南充市顺庆区公安局	四川省南充市顺庆区
南充市西充县公安局	四川省南充市西充县
南充市阆中市公安局	四川省南充市阆中市
南充市高坪区公安局	四川省南充市高坪区
南充市营山县公安局	四川省南充市营山县
南充市嘉陵区公安局	四川省南充市嘉陵区
南充市仪陇县公安局	四川省南充市仪陇县
乐山市金口河区公安局	四川省乐山市金口河区
乐山市沙湾区公安局	四川省乐山市沙湾区
乐山市马边彝族自治县公安局	四川省乐山市马边彝族自治县
乐山市井研县公安局	四川省乐山市井研县
乐山市峨眉山市公安局	四川省乐山市峨眉山市
乐山市沐川县公安局	四川省乐山市沐川县
乐山市犍为县公安局	四川省乐山市犍为县
乐山市夹江县公安局	四川省乐山市夹江县
乐山市峨边彝族自治县公安局	四川省乐山市峨边彝族自治县
乐山市市中区公安局	四川省乐山市市中区
乐山市五通桥区公安局	四川省乐山市五通桥区
宜宾市宜宾县公安局	四川省宜宾市宜宾县
巴中市巴中经济开发区公安局	四川省巴中市巴中经济开发区
巴中市恩阳区公安局	四川省巴中市恩阳区
巴中市通江县公安局	四川省巴中市通江县
巴中市南江县公安局	四川省巴中市南江县
巴中市平昌县公安局	四川省巴中市平昌县
巴中市巴州区公安局	四川省巴中市巴州区
凉山彝族自治州布拖县公安局	四川省凉山彝族自治州布拖县
凉山彝族自治州越西县公安局	四川省凉山彝族自治州越西县
凉山彝族自治州喜德县公安局	四川省凉山彝族自治州喜德县
凉山彝族自治州甘洛县公安局	四川省凉山彝族自治州甘洛县
凉山彝族自治州德昌县公安局	四川省凉山彝族自治州德昌县
凉山彝族自治州雷波县公安局	四川省凉山彝族自治州雷波县
凉山彝族自治州会理县公安局	四川省凉山彝族自治州会理县
凉山彝族自治州会东县公安局	四川省凉山彝族自治州会东县
凉山彝族自治州金阳县公安局	四川省凉山彝族自治州金阳县
凉山彝族自治州冕宁县公安局	四川省凉山彝族自治州冕宁县
凉山彝族自治州普格县公安局	四川省凉山彝族自治州普格县
凉山彝族自治州木里藏族自治县公安局	四川省凉山彝族自治州木里藏族自治县
凉山彝族自治州盐源县公安局	四川省凉山彝族自治州盐源县
凉山彝族自治州宁南县公安局	四川省凉山彝族自治州宁南县
凉山彝族自治州昭觉县公安局	四川省凉山彝族自治州昭觉县
凉山彝族自治州美姑县公安局	四川省凉山彝族自治州美姑县
凉山彝族自治州西昌市公安局	四川省凉山彝族自治州西昌市
阿坝藏族羌族自治州马尔康市公安局	四川省阿坝藏族羌族自治州马尔康市
阿坝藏族羌族自治州茂县公安局	四川省阿坝藏族羌族自治州茂县
阿坝藏族羌族自治州小金县公安局	四川省阿坝藏族羌族自治州小金县
阿坝藏族羌族自治州黑水县公安局	四川省阿坝藏族羌族自治州黑水县
阿坝藏族羌族自治州阿坝县公安局	四川省阿坝藏族羌族自治州阿坝县
阿坝藏族羌族自治州松潘县公安局	四川省阿坝藏族羌族自治州松潘县
阿坝藏族羌族自治州理县公安局	四川省阿坝藏族羌族自治州理县
阿坝藏族羌族自治州九寨沟县公安局	四川省阿坝藏族羌族自治州九寨沟县
阿坝藏族羌族自治州若尔盖县公安局	四川省阿坝藏族羌族自治州若尔盖县
阿坝藏族羌族自治州汶川县公安局	四川省阿坝藏族羌族自治州汶川县
阿坝藏族羌族自治州红原县公安局	四川省阿坝藏族羌族自治州红原县
阿坝藏族羌族自治州壤塘县公安局	四川省阿坝藏族羌族自治州壤塘县
阿坝藏族羌族自治州金川县公安局	四川省阿坝藏族羌族自治州金川县
甘孜藏族自治州雅江县公安局	四川省甘孜藏族自治州雅江县
甘孜藏族自治州乡城县公安局	四川省甘孜藏族自治州乡城县
甘孜藏族自治州丹巴县公安局	四川省甘孜藏族自治州丹巴县
甘孜藏族自治州白玉县公安局	四川省甘孜藏族自治州白玉县
甘孜藏族自治州康定市公安局	四川省甘孜藏族自治州康定市
甘孜藏族自治州理塘县公安局	四川省甘孜藏族自治州理塘县
甘孜藏族自治州得荣县公安局	四川省甘孜藏族自治州得荣县
甘孜藏族自治州石渠县公安局	四川省甘孜藏族自治州石渠县
甘孜藏族自治州稻城县公安局	四川省甘孜藏族自治州稻城县
甘孜藏族自治州泸定县公安局	四川省甘孜藏族自治州泸定县
甘孜藏族自治州新龙县公安局	四川省甘孜藏族自治州新龙县
甘孜藏族自治州巴塘县公安局	四川省甘孜藏族自治州巴塘县
甘孜藏族自治州甘孜县公安局	四川省甘孜藏族自治州甘孜县
甘孜藏族自治州德格县公安局	四川省甘孜藏族自治州德格县
甘孜藏族自治州炉霍县公安局	四川省甘孜藏族自治州炉霍县
甘孜藏族自治州九龙县公安局	四川省甘孜藏族自治州九龙县
甘孜藏族自治州色达县公安局	四川省甘孜藏族自治州色达县
甘孜藏族自治州道孚县公安局	四川省甘孜藏族自治州道孚县
自贡市沿滩区公安局	四川省自贡市沿滩区
自贡市荣县公安局	四川省自贡市荣县
自贡市贡井区公安局	四川省自贡市贡井区
自贡市富顺县公安局	四川省自贡市富顺县
自贡市自流井区公安局	四川省自贡市自流井区
自贡市大安区公安局	四川省自贡市大安区
广元市剑阁县公安局	四川省广元市剑阁县
广元市朝天区公安局	四川省广元市朝天区
眉山市丹棱县公安局	四川省眉山市丹棱县
眉山市东坡区公安局	四川省眉山市东坡区
眉山市青神县公安局	四川省眉山市青神县
眉山市仁寿县公安局	四川省眉山市仁寿县
眉山市彭山区公安局	四川省眉山市彭山区
眉山市洪雅县公安局	四川省眉山市洪雅县
济南市济阳县公安局	山东省济南市济阳县
滨州市邹平县公安局	山东省滨州市邹平县
日照市日照国际海洋城公安局	山东省日照市日照国际海洋城
株洲市株洲县公安局	湖南省株洲市株洲县
黔西南布依族苗族自治州册亨县公安局	贵州省黔西南布依族苗族自治州册亨县
黔西南布依族苗族自治州兴仁县公安局	贵州省黔西南布依族苗族自治州兴仁县
黔西南布依族苗族自治州兴义市公安局	贵州省黔西南布依族苗族自治州兴义市
黔西南布依族苗族自治州普安县公安局	贵州省黔西南布依族苗族自治州普安县
黔西南布依族苗族自治州晴隆县公安局	贵州省黔西南布依族苗族自治州晴隆县
黔西南布依族苗族自治州贞丰县公安局	贵州省黔西南布依族苗族自治州贞丰县
黔西南布依族苗族自治州望谟县公安局	贵州省黔西南布依族苗族自治州望谟县
黔西南布依族苗族自治州安龙县公安局	贵州省黔西南布依族苗族自治州安龙县
黔东南苗族侗族自治州岑巩县公安局	贵州省黔东南苗族侗族自治州岑巩县
黔东南苗族侗族自治州剑河县公安局	贵州省黔东南苗族侗族自治州剑河县
黔东南苗族侗族自治州镇远县公安局	贵州省黔东南苗族侗族自治州镇远县
黔东南苗族侗族自治州丹寨县公安局	贵州省黔东南苗族侗族自治州丹寨县
黔东南苗族侗族自治州天柱县公安局	贵州省黔东南苗族侗族自治州天柱县
黔东南苗族侗族自治州黄平县公安局	贵州省黔东南苗族侗族自治州黄平县
黔东南苗族侗族自治州锦屏县公安局	贵州省黔东南苗族侗族自治州锦屏县
黔东南苗族侗族自治州台江县公安局	贵州省黔东南苗族侗族自治州台江县
黔东南苗族侗族自治州雷山县公安局	贵州省黔东南苗族侗族自治州雷山县
黔东南苗族侗族自治州黎平县公安局	贵州省黔东南苗族侗族自治州黎平县
黔东南苗族侗族自治州从江县公安局	贵州省黔东南苗族侗族自治州从江县
黔东南苗族侗族自治州施秉县公安局	贵州省黔东南苗族侗族自治州施秉县
黔东南苗族侗族自治州麻江县公安局	贵州省黔东南苗族侗族自治州麻江县
黔东南苗族侗族自治州榕江县公安局	贵州省黔东南苗族侗族自治州榕江县
黔东南苗族侗族自治州凯里市公安局	贵州省黔东南苗族侗族自治州凯里市
黔东南苗族侗族自治州三穗县公安局	贵州省黔东南苗族侗族自治州三穗县
六盘水市盘州市公安局	贵州省六盘水市盘州市
六盘水市六枝特区公安局	贵州省六盘水市六枝特区
六盘水市水城县公安局	贵州省六盘水市水城县
六盘水市钟山区公安局	贵州省六盘水市钟山区
遵义市桐梓县公安局	贵州省遵义市桐梓县
遵义市绥阳县公安局	贵州省遵义市绥阳县
遵义市习水县公安局	贵州省遵义市习水县
遵义市道真仡佬族苗族自治县公安局	贵州省遵义市道真仡佬族苗族自治县
遵义市余庆县公安局	贵州省遵义市余庆县
遵义市务川仡佬族苗族自治县公安局	贵州省遵义市务川仡佬族苗族自治县
遵义市正安县公安局	贵州省遵义市正安县
遵义市湄潭县公安局	贵州省遵义市湄潭县
遵义市凤冈县公安局	贵州省遵义市凤冈县
遵义市红花岗区公安局	贵州省遵义市红花岗区
遵义市汇川区公安局	贵州省遵义市汇川区
遵义市仁怀市公安局	贵州省遵义市仁怀市
遵义市播州区公安局	贵州省遵义市播州区
遵义市赤水市公安局	贵州省遵义市赤水市
贵阳市乌当区公安局	贵州省贵阳市乌当区
贵阳市白云区公安局	贵州省贵阳市白云区
贵阳市云岩区公安局	贵州省贵阳市云岩区
贵阳市南明区公安局	贵州省贵阳市南明区
贵阳市开阳县公安局	贵州省贵阳市开阳县
贵阳市花溪区公安局	贵州省贵阳市花溪区
贵阳市修文县公安局	贵州省贵阳市修文县
贵阳市息烽县公安局	贵州省贵阳市息烽县
贵阳市观山湖区公安局	贵州省贵阳市观山湖区
贵阳市清镇市公安局	贵州省贵阳市清镇市
毕节市大方县公安局	贵州省毕节市大方县
毕节市织金县公安局	贵州省毕节市织金县
毕节市七星关区公安局	贵州省毕节市七星关区
毕节市金沙县公安局	贵州省毕节市金沙县
毕节市纳雍县公安局	贵州省毕节市纳雍县
毕节市赫章县公安局	贵州省毕节市赫章县
毕节市威宁彝族回族苗族自治县公安局	贵州省毕节市威宁彝族回族苗族自治县
毕节市黔西县公安局	贵州省毕节市黔西县
安顺市关岭布依族苗族自治县公安局	贵州省安顺市关岭布依族苗族自治县
安顺市镇宁布依族苗族自治县公安局	贵州省安顺市镇宁布依族苗族自治县
安顺市平坝区公安局	贵州省安顺市平坝区
安顺市西秀区公安局	贵州省安顺市西秀区
安顺市紫云苗族布依族自治县公安局	贵州省安顺市紫云苗族布依族自治县
安顺市普定县公安局	贵州省安顺市普定县
铜仁市沿河土家族自治县公安局	贵州省铜仁市沿河土家族自治县
铜仁市江口县公安局	贵州省铜仁市江口县
铜仁市德江县公安局	贵州省铜仁市德江县
铜仁市石阡县公安局	贵州省铜仁市石阡县
铜仁市思南县公安局	贵州省铜仁市思南县
铜仁市松桃苗族自治县公安局	贵州省铜仁市松桃苗族自治县
铜仁市万山区公安局	贵州省铜仁市万山区
铜仁市印江土家族苗族自治县公安局	贵州省铜仁市印江土家族苗族自治县
铜仁市碧江区公安局	贵州省铜仁市碧江区
铜仁市玉屏侗族自治县公安局	贵州省铜仁市玉屏侗族自治县
黔南布依族苗族自治州平塘县公安局	贵州省黔南布依族苗族自治州平塘县
黔南布依族苗族自治州瓮安县公安局	贵州省黔南布依族苗族自治州瓮安县
黔南布依族苗族自治州荔波县公安局	贵州省黔南布依族苗族自治州荔波县
黔南布依族苗族自治州福泉市公安局	贵州省黔南布依族苗族自治州福泉市
黔南布依族苗族自治州惠水县公安局	贵州省黔南布依族苗族自治州惠水县
黔南布依族苗族自治州都匀市公安局	贵州省黔南布依族苗族自治州都匀市
黔南布依族苗族自治州罗甸县公安局	贵州省黔南布依族苗族自治州罗甸县
黔南布依族苗族自治州龙里县公安局	贵州省黔南布依族苗族自治州龙里县
黔南布依族苗族自治州独山县公安局	贵州省黔南布依族苗族自治州独山县
黔南布依族苗族自治州长顺县公安局	贵州省黔南布依族苗族自治州长顺县
黔南布依族苗族自治州贵定县公安局	贵州省黔南布依族苗族自治州贵定县
黔南布依族苗族自治州三都水族自治县公安局	贵州省黔南布依族苗族自治州三都水族自治县
阳泉市山西阳泉经济开发区公安局	山西省阳泉市山西阳泉经济开发区
长治市城区公安局	山西省长治市城区
长治市郊区公安局	山西省长治市郊区
长治市屯留县公安局	山西省长治市屯留县
长治市潞城市公安局	山西省长治市潞城市
长治市长治县公安局	山西省长治市长治县
朔州市怀仁县公安局	山西省朔州市怀仁县
大同市矿区公安局	山西省大同市矿区
大同市南郊区公安局	山西省大同市南郊区
大同市大同县公安局	山西省大同市大同县
大同市城区公安局	山西省大同市城区
南通市海安县公安局	江苏省南通市海安县
珠海市香洲区公安局	广东省珠海市香洲区
珠海市斗门区公安局	广东省珠海市斗门区
珠海市金湾区公安局	广东省珠海市金湾区
肇庆市怀集县公安局	广东省肇庆市怀集县
肇庆市广宁县公安局	广东省肇庆市广宁县
肇庆市鼎湖区公安局	广东省肇庆市鼎湖区
肇庆市封开县公安局	广东省肇庆市封开县
肇庆市德庆县公安局	广东省肇庆市德庆县
肇庆市高要区公安局	广东省肇庆市高要区
肇庆市四会市公安局	广东省肇庆市四会市
肇庆市端州区公安局	广东省肇庆市端州区
惠州市龙门县公安局	广东省惠州市龙门县
惠州市惠城区公安局	广东省惠州市惠城区
惠州市惠东县公安局	广东省惠州市惠东县
惠州市惠阳区公安局	广东省惠州市惠阳区
惠州市博罗县公安局	广东省惠州市博罗县
清远市清城区公安局	广东省清远市清城区
清远市佛冈县公安局	广东省清远市佛冈县
清远市连山壮族瑶族自治县公安局	广东省清远市连山壮族瑶族自治县
清远市连南瑶族自治县公安局	广东省清远市连南瑶族自治县
清远市英德市公安局	广东省清远市英德市
清远市阳山县公安局	广东省清远市阳山县
清远市连州市公安局	广东省清远市连州市
清远市清新区公安局	广东省清远市清新区
河源市东源县公安局	广东省河源市东源县
河源市连平县公安局	广东省河源市连平县
河源市源城区公安局	广东省河源市源城区
河源市紫金县公安局	广东省河源市紫金县
河源市龙川县公安局	广东省河源市龙川县
河源市和平县公安局	广东省河源市和平县
江门市江海区公安局	广东省江门市江海区
江门市蓬江区公安局	广东省江门市蓬江区
江门市恩平市公安局	广东省江门市恩平市
江门市新会区公安局	广东省江门市新会区
江门市鹤山市公安局	广东省江门市鹤山市
江门市开平市公安局	广东省江门市开平市
江门市台山市公安局	广东省江门市台山市
湛江市雷州市公安局	广东省湛江市雷州市
湛江市坡头区公安局	广东省湛江市坡头区
湛江市麻章区公安局	广东省湛江市麻章区
湛江市遂溪县公安局	广东省湛江市遂溪县
湛江市徐闻县公安局	广东省湛江市徐闻县
湛江市赤坎区公安局	广东省湛江市赤坎区
湛江市廉江市公安局	广东省湛江市廉江市
湛江市吴川市公安局	广东省湛江市吴川市
湛江市霞山区公安局	广东省湛江市霞山区
广州市海珠区公安局	广东省广州市海珠区
广州市越秀区公安局	广东省广州市越秀区
广州市天河区公安局	广东省广州市天河区
广州市荔湾区公安局	广东省广州市荔湾区
广州市黄埔区公安局	广东省广州市黄埔区
广州市增城区公安局	广东省广州市增城区
广州市白云区公安局	广东省广州市白云区
广州市番禺区公安局	广东省广州市番禺区
广州市花都区公安局	广东省广州市花都区
广州市南沙区公安局	广东省广州市南沙区
广州市从化区公安局	广东省广州市从化区
汕头市潮阳区公安局	广东省汕头市潮阳区
汕头市澄海区公安局	广东省汕头市澄海区
汕头市濠江区公安局	广东省汕头市濠江区
汕头市南澳县公安局	广东省汕头市南澳县
汕头市潮南区公安局	广东省汕头市潮南区
潮州市饶平县公安局	广东省潮州市饶平县
潮州市湘桥区公安局	广东省潮州市湘桥区
潮州市潮安区公安局	广东省潮州市潮安区
茂名市高州市公安局	广东省茂名市高州市
茂名市化州市公安局	广东省茂名市化州市
茂名市信宜市公安局	广东省茂名市信宜市
茂名市电白区公安局	广东省茂名市电白区
茂名市茂南区公安局	广东省茂名市茂南区
汕尾市城区公安局	广东省汕尾市城区
汕尾市陆河县公安局	广东省汕尾市陆河县
汕尾市海丰县公安局	广东省汕尾市海丰县
汕尾市陆丰市公安局	广东省汕尾市陆丰市
阳江市江城区公安局	广东省阳江市江城区
阳江市阳春市公安局	广东省阳江市阳春市
阳江市阳西县公安局	广东省阳江市阳西县
阳江市阳东区公安局	广东省阳江市阳东区
深圳市南山区公安局	广东省深圳市南山区
深圳市龙岗区公安局	广东省深圳市龙岗区
深圳市坪山区公安局	广东省深圳市坪山区
深圳市盐田区公安局	广东省深圳市盐田区
深圳市龙华区公安局	广东省深圳市龙华区
深圳市宝安区公安局	广东省深圳市宝安区
东莞市东莞市公安局	广东省东莞市东莞市
克拉玛依市乌尔禾区公安局	新疆维吾尔自治区克拉玛依市乌尔禾区
克拉玛依市独山子区公安局	新疆维吾尔自治区克拉玛依市独山子区
克拉玛依市白碱滩区公安局	新疆维吾尔自治区克拉玛依市白碱滩区
克拉玛依市克拉玛依区公安局	新疆维吾尔自治区克拉玛依市克拉玛依区
伊犁哈萨克自治州伊宁县公安局	新疆维吾尔自治区伊犁哈萨克自治州伊宁县
伊犁哈萨克自治州霍城县公安局	新疆维吾尔自治区伊犁哈萨克自治州霍城县
伊犁哈萨克自治州新源县公安局	新疆维吾尔自治区伊犁哈萨克自治州新源县
伊犁哈萨克自治州巩留县公安局	新疆维吾尔自治区伊犁哈萨克自治州巩留县
伊犁哈萨克自治州昭苏县公安局	新疆维吾尔自治区伊犁哈萨克自治州昭苏县
伊犁哈萨克自治州察布查尔锡伯自治县公安局	新疆维吾尔自治区伊犁哈萨克自治州察布查尔锡伯自治县
伊犁哈萨克自治州奎屯市公安局	新疆维吾尔自治区伊犁哈萨克自治州奎屯市
伊犁哈萨克自治州特克斯县公安局	新疆维吾尔自治区伊犁哈萨克自治州特克斯县
伊犁哈萨克自治州霍尔果斯市公安局	新疆维吾尔自治区伊犁哈萨克自治州霍尔果斯市
伊犁哈萨克自治州伊宁市公安局	新疆维吾尔自治区伊犁哈萨克自治州伊宁市
伊犁哈萨克自治州尼勒克县公安局	新疆维吾尔自治区伊犁哈萨克自治州尼勒克县
巴音郭楞蒙古自治州库尔勒市公安局	新疆维吾尔自治区巴音郭楞蒙古自治州库尔勒市
巴音郭楞蒙古自治州库尔勒经济技术开发区公安局	新疆维吾尔自治区巴音郭楞蒙古自治州库尔勒经济技术开发区
巴音郭楞蒙古自治州博湖县公安局	新疆维吾尔自治区巴音郭楞蒙古自治州博湖县
巴音郭楞蒙古自治州尉犁县公安局	新疆维吾尔自治区巴音郭楞蒙古自治州尉犁县
巴音郭楞蒙古自治州且末县公安局	新疆维吾尔自治区巴音郭楞蒙古自治州且末县
巴音郭楞蒙古自治州若羌县公安局	新疆维吾尔自治区巴音郭楞蒙古自治州若羌县
巴音郭楞蒙古自治州焉耆回族自治县公安局	新疆维吾尔自治区巴音郭楞蒙古自治州焉耆回族自治县
巴音郭楞蒙古自治州和硕县公安局	新疆维吾尔自治区巴音郭楞蒙古自治州和硕县
巴音郭楞蒙古自治州和静县公安局	新疆维吾尔自治区巴音郭楞蒙古自治州和静县
巴音郭楞蒙古自治州轮台县公安局	新疆维吾尔自治区巴音郭楞蒙古自治州轮台县
塔城地区乌苏市公安局	新疆维吾尔自治区塔城地区乌苏市
喀什地区疏勒县公安局	新疆维吾尔自治区喀什地区疏勒县
喀什地区泽普县公安局	新疆维吾尔自治区喀什地区泽普县
喀什地区塔什库尔干塔吉克自治县公安局	新疆维吾尔自治区喀什地区塔什库尔干塔吉克自治县
喀什地区麦盖提县公安局	新疆维吾尔自治区喀什地区麦盖提县
喀什地区巴楚县公安局	新疆维吾尔自治区喀什地区巴楚县
揭阳市普宁市公安局	广东省揭阳市普宁市
揭阳市揭西县公安局	广东省揭阳市揭西县
揭阳市惠来县公安局	广东省揭阳市惠来县
揭阳市榕城区公安局	广东省揭阳市榕城区
揭阳市揭东区公安局	广东省揭阳市揭东区
梅州市梅县区公安局	广东省梅州市梅县区
梅州市蕉岭县公安局	广东省梅州市蕉岭县
梅州市兴宁市公安局	广东省梅州市兴宁市
梅州市丰顺县公安局	广东省梅州市丰顺县
梅州市大埔县公安局	广东省梅州市大埔县
梅州市梅江区公安局	广东省梅州市梅江区
梅州市五华县公安局	广东省梅州市五华县
梅州市平远县公安局	广东省梅州市平远县
深圳市福田区公安局	广东省深圳市福田区
深圳市罗湖区公安局	广东省深圳市罗湖区
韶关市仁化县公安局	广东省韶关市仁化县
韶关市南雄市公安局	广东省韶关市南雄市
韶关市浈江区公安局	广东省韶关市浈江区
韶关市始兴县公安局	广东省韶关市始兴县
韶关市武江区公安局	广东省韶关市武江区
韶关市翁源县公安局	广东省韶关市翁源县
韶关市乐昌市公安局	广东省韶关市乐昌市
韶关市新丰县公安局	广东省韶关市新丰县
韶关市乳源瑶族自治县公安局	广东省韶关市乳源瑶族自治县
韶关市曲江区公安局	广东省韶关市曲江区
云浮市云城区公安局	广东省云浮市云城区
云浮市罗定市公安局	广东省云浮市罗定市
云浮市新兴县公安局	广东省云浮市新兴县
云浮市云安区公安局	广东省云浮市云安区
云浮市郁南县公安局	广东省云浮市郁南县
佛山市顺德区公安局	广东省佛山市顺德区
佛山市高明区公安局	广东省佛山市高明区
佛山市禅城区公安局	广东省佛山市禅城区
佛山市三水区公安局	广东省佛山市三水区
佛山市南海区公安局	广东省佛山市南海区
中山市中山市公安局	广东省中山市中山市
荆门市京山县公安局	湖北省荆门市京山县
曲靖市会泽县公安局	云南省曲靖市会泽县
曲靖市陆良县公安局	云南省曲靖市陆良县
曲靖市马龙县公安局	云南省曲靖市马龙县
昭通市水富县公安局	云南省昭通市水富县
怒江傈僳族自治州泸水市公安局	云南省怒江傈僳族自治州泸水市
怒江傈僳族自治州福贡县公安局	云南省怒江傈僳族自治州福贡县
怒江傈僳族自治州贡山独龙族怒族自治县公安局	云南省怒江傈僳族自治州贡山独龙族怒族自治县
怒江傈僳族自治州兰坪白族普米族自治县公安局	云南省怒江傈僳族自治州兰坪白族普米族自治县
福州市长乐市公安局	福建省福州市长乐市
兰州市榆中县公安局	甘肃省兰州市榆中县
兰州市兰州新区公安局	甘肃省兰州市兰州新区
兰州市西固区公安局	甘肃省兰州市西固区
兰州市皋兰县公安局	甘肃省兰州市皋兰县
兰州市红古区公安局	甘肃省兰州市红古区
兰州市永登县公安局	甘肃省兰州市永登县
兰州市七里河区公安局	甘肃省兰州市七里河区
兰州市城关区公安局	甘肃省兰州市城关区
兰州市安宁区公安局	甘肃省兰州市安宁区
白银市靖远县公安局	甘肃省白银市靖远县
白银市景泰县公安局	甘肃省白银市景泰县
白银市白银区公安局	甘肃省白银市白银区
白银市会宁县公安局	甘肃省白银市会宁县
白银市平川区公安局	甘肃省白银市平川区
嘉峪关市市辖区公安局	甘肃省嘉峪关市嘉峪关市镜铁区
定西市安定区公安局	甘肃省定西市安定区
定西市陇西县公安局	甘肃省定西市陇西县
定西市漳县公安局	甘肃省定西市漳县
定西市渭源县公安局	甘肃省定西市渭源县
定西市通渭县公安局	甘肃省定西市通渭县
张掖市民乐县公安局	甘肃省张掖市民乐县
张掖市甘州区公安局	甘肃省张掖市甘州区
张掖市肃南裕固族自治县公安局	甘肃省张掖市肃南裕固族自治县
张掖市临泽县公安局	甘肃省张掖市临泽县
张掖市山丹县公安局	甘肃省张掖市山丹县
张掖市高台县公安局	甘肃省张掖市高台县
平凉市平凉工业园区公安局	甘肃省平凉市平凉工业园区
平凉市华亭县公安局	甘肃省平凉市华亭县
临夏回族自治州积石山保安族东乡族撒拉族自治县公安局	甘肃省临夏回族自治州积石山保安族东乡族撒拉族自治县
临夏回族自治州临夏县公安局	甘肃省临夏回族自治州临夏县
临夏回族自治州临夏市公安局	甘肃省临夏回族自治州临夏市
临夏回族自治州东乡族自治县公安局	甘肃省临夏回族自治州东乡族自治县
临夏回族自治州康乐县公安局	甘肃省临夏回族自治州康乐县
临夏回族自治州广河县公安局	甘肃省临夏回族自治州广河县
临夏回族自治州和政县公安局	甘肃省临夏回族自治州和政县
临夏回族自治州永靖县公安局	甘肃省临夏回族自治州永靖县
唐山市滦县公安局	河北省唐山市滦县
咸阳市彬县公安局	陕西省咸阳市彬县
拉萨市达孜县公安局	西藏自治区拉萨市达孜县
那曲地区比如县公安局	西藏自治区那曲地区比如县
那曲地区嘉黎县公安局	西藏自治区那曲地区嘉黎县
那曲地区索县公安局	西藏自治区那曲地区索县
那曲地区班戈县公安局	西藏自治区那曲地区班戈县
那曲地区申扎县公安局	西藏自治区那曲地区申扎县
那曲地区那曲县公安局	西藏自治区那曲地区那曲县
那曲地区尼玛县公安局	西藏自治区那曲地区尼玛县
那曲地区安多县公安局	西藏自治区那曲地区安多县
那曲地区双湖县公安局	西藏自治区那曲地区双湖县
那曲地区聂荣县公安局	西藏自治区那曲地区聂荣县
那曲地区巴青县公安局	西藏自治区那曲地区巴青县
大兴安岭地区漠河县公安局	黑龙江省大兴安岭地区漠河县
大兴安岭地区松岭区公安局	黑龙江省大兴安岭地区松岭区
大兴安岭地区呼中区公安局	黑龙江省大兴安岭地区呼中区
大兴安岭地区新林区公安局	黑龙江省大兴安岭地区新林区
阿拉善盟阿拉善左旗公安局	内蒙古自治区阿拉善盟阿拉善左旗
阿拉善盟额济纳旗公安局	内蒙古自治区阿拉善盟额济纳旗
阿拉善盟内蒙古阿拉善经济开发区公安局	内蒙古自治区阿拉善盟内蒙古阿拉善经济开发区
阿拉善盟阿拉善右旗公安局	内蒙古自治区阿拉善盟阿拉善右旗
乌海市海勃湾区公安局	内蒙古自治区乌海市海勃湾区
乌海市海南区公安局	内蒙古自治区乌海市海南区
乌海市乌达区公安局	内蒙古自治区乌海市乌达区
呼伦贝尔市海拉尔区公安局	内蒙古自治区呼伦贝尔市海拉尔区
呼伦贝尔市根河市公安局	内蒙古自治区呼伦贝尔市根河市
呼伦贝尔市新巴尔虎右旗公安局	内蒙古自治区呼伦贝尔市新巴尔虎右旗
呼伦贝尔市扎赉诺尔区公安局	内蒙古自治区呼伦贝尔市扎赉诺尔区
呼伦贝尔市牙克石市公安局	内蒙古自治区呼伦贝尔市牙克石市
呼伦贝尔市额尔古纳市公安局	内蒙古自治区呼伦贝尔市额尔古纳市
呼伦贝尔市陈巴尔虎旗公安局	内蒙古自治区呼伦贝尔市陈巴尔虎旗
通辽市库伦旗公安局	内蒙古自治区通辽市库伦旗
通辽市奈曼旗公安局	内蒙古自治区通辽市奈曼旗
通辽市扎鲁特旗公安局	内蒙古自治区通辽市扎鲁特旗
通辽市科尔沁区公安局	内蒙古自治区通辽市科尔沁区
通辽市开鲁县公安局	内蒙古自治区通辽市开鲁县
通辽市科尔沁左翼后旗公安局	内蒙古自治区通辽市科尔沁左翼后旗
通辽市通辽经济技术开发区公安局	内蒙古自治区通辽市通辽经济技术开发区
通辽市科尔沁左翼中旗公安局	内蒙古自治区通辽市科尔沁左翼中旗
通辽市霍林郭勒市公安局	内蒙古自治区通辽市霍林郭勒市
